municipality,group,variable,month,< de 2 años-H,< de 2 años-M,2 a 4 años-H,2 a 4 años-M,TOTAL-H,TOTAL-M,TOTAL
AIQUILE,desnutricion aguda,desnutricion grave (g),2007-01-01,3,1,0,1,3,2,5
ALALAY,desnutricion aguda,desnutricion grave (g),2007-01-01,2,0,1,0,3,0,3
ANZALDO,desnutricion aguda,desnutricion grave (g),2007-01-01,1,0,0,0,1,0,1
ARAMPAMPA,desnutricion aguda,desnutricion grave (g),2007-01-01,3,2,4,3,7,5,12
ARANI,desnutricion aguda,desnutricion grave (g),2007-01-01,0,0,1,0,1,0,1
ARBIETO,desnutricion aguda,desnutricion grave (g),2007-01-01,2,0,0,0,2,0,2
ARQUE,desnutricion aguda,desnutricion grave (g),2007-01-01,1,2,1,2,2,4,6
ATOCHA,desnutricion aguda,desnutricion grave (g),2007-01-01,0,0,1,0,1,0,1
AZURDUY,desnutricion aguda,desnutricion grave (g),2007-01-01,0,3,1,1,1,4,5
BAURES,desnutricion aguda,desnutricion grave (g),2007-01-01,0,1,0,0,0,1,1
BELEN DE ANDAMARCA,desnutricion aguda,desnutricion grave (g),2007-01-01,1,0,0,0,1,0,1
BELLA FLOR,desnutricion aguda,desnutricion grave (g),2007-01-01,0,0,0,1,0,1,1
BERMEJO,desnutricion aguda,desnutricion grave (g),2007-01-01,0,0,0,1,0,1,1
BETANZOS,desnutricion aguda,desnutricion grave (g),2007-01-01,4,4,0,0,4,4,8
BOLIVAR,desnutricion aguda,desnutricion grave (g),2007-01-01,3,2,1,2,4,4,8
BOYUIBE,desnutricion aguda,desnutricion grave (g),2007-01-01,1,0,0,0,1,0,1
CABEZAS,desnutricion aguda,desnutricion grave (g),2007-01-01,0,1,0,1,0,2,2
CAJUATA,desnutricion aguda,desnutricion grave (g),2007-01-01,1,0,0,0,1,0,1
CAMARGO,desnutricion aguda,desnutricion grave (g),2007-01-01,2,2,0,0,2,2,4
CAMIRI,desnutricion aguda,desnutricion grave (g),2007-01-01,1,0,0,1,1,1,2
CAPINOTA,desnutricion aguda,desnutricion grave (g),2007-01-01,4,4,1,2,5,6,11
CARACOLLO,desnutricion aguda,desnutricion grave (g),2007-01-01,1,0,0,0,1,0,1
CARAPARI,desnutricion aguda,desnutricion grave (g),2007-01-01,2,0,0,0,2,0,2
CARIPUYO,desnutricion aguda,desnutricion grave (g),2007-01-01,1,2,1,4,2,6,8
CHALLAPATA,desnutricion aguda,desnutricion grave (g),2007-01-01,2,2,1,0,3,2,5
CHAQUI,desnutricion aguda,desnutricion grave (g),2007-01-01,3,1,0,1,3,2,5
CHARAGUA,desnutricion aguda,desnutricion grave (g),2007-01-01,3,1,0,2,3,3,6
CHAYANTA,desnutricion aguda,desnutricion grave (g),2007-01-01,0,1,0,2,0,3,3
CHIMORE,desnutricion aguda,desnutricion grave (g),2007-01-01,7,3,0,2,7,5,12
COCHABAMBA,desnutricion aguda,desnutricion grave (g),2007-01-01,28,15,16,8,44,23,67
COLOMI,desnutricion aguda,desnutricion grave (g),2007-01-01,1,1,2,0,3,1,4
COLPA BELGICA,desnutricion aguda,desnutricion grave (g),2007-01-01,2,0,0,0,2,0,2
COLQUECHACA,desnutricion aguda,desnutricion grave (g),2007-01-01,7,3,1,0,8,3,11
COMARAPA,desnutricion aguda,desnutricion grave (g),2007-01-01,0,1,0,0,0,1,1
CONCEPCION,desnutricion aguda,desnutricion grave (g),2007-01-01,1,0,2,0,3,0,3
CORQUE,desnutricion aguda,desnutricion grave (g),2007-01-01,0,0,0,2,0,2,2
COTAGAITA,desnutricion aguda,desnutricion grave (g),2007-01-01,1,0,1,1,2,1,3
CUATRO CAÑADAS,desnutricion aguda,desnutricion grave (g),2007-01-01,0,1,0,0,0,1,1
CUEVO,desnutricion aguda,desnutricion grave (g),2007-01-01,2,0,0,1,2,1,3
CULPINA,desnutricion aguda,desnutricion grave (g),2007-01-01,4,1,1,1,5,2,7
EL PUENTE(STC),desnutricion aguda,desnutricion grave (g),2007-01-01,1,0,0,0,1,0,1
EL PUENTE(TJA),desnutricion aguda,desnutricion grave (g),2007-01-01,1,0,0,0,1,0,1
EL VILLAR,desnutricion aguda,desnutricion grave (g),2007-01-01,0,1,0,2,0,3,3
ENTRE RIOS,desnutricion aguda,desnutricion grave (g),2007-01-01,0,0,1,0,1,0,1
ENTRE RIOS,desnutricion aguda,desnutricion grave (g),2007-01-01,2,1,1,0,3,1,4
GENERAL SAAVEDRA,desnutricion aguda,desnutricion grave (g),2007-01-01,3,4,0,1,3,5,8
GUAYARAMERIN,desnutricion aguda,desnutricion grave (g),2007-01-01,0,3,1,4,1,7,8
GUTIERREZ,desnutricion aguda,desnutricion grave (g),2007-01-01,0,1,1,1,1,2,3
HUACARETA,desnutricion aguda,desnutricion grave (g),2007-01-01,2,0,0,0,2,0,2
HUANUNI,desnutricion aguda,desnutricion grave (g),2007-01-01,0,2,3,0,3,2,5
ICLA,desnutricion aguda,desnutricion grave (g),2007-01-01,2,2,2,2,4,4,8
INCAHUASI,desnutricion aguda,desnutricion grave (g),2007-01-01,3,2,1,2,4,4,8
INQUISIVI,desnutricion aguda,desnutricion grave (g),2007-01-01,3,0,0,0,3,0,3
LA GUARDIA,desnutricion aguda,desnutricion grave (g),2007-01-01,4,2,1,1,5,3,8
LAGUNILLAS,desnutricion aguda,desnutricion grave (g),2007-01-01,0,1,0,0,0,1,1
LAS CARRERAS,desnutricion aguda,desnutricion grave (g),2007-01-01,0,1,0,0,0,1,1
LLALLAGUA,desnutricion aguda,desnutricion grave (g),2007-01-01,5,4,5,5,10,9,19
MACHARETI,desnutricion aguda,desnutricion grave (g),2007-01-01,0,0,1,0,1,0,1
MINEROS,desnutricion aguda,desnutricion grave (g),2007-01-01,1,0,0,0,1,0,1
MIZQUE,desnutricion aguda,desnutricion grave (g),2007-01-01,3,0,0,0,3,0,3
MONTEAGUDO,desnutricion aguda,desnutricion grave (g),2007-01-01,2,3,3,2,5,5,10
MONTERO,desnutricion aguda,desnutricion grave (g),2007-01-01,17,3,3,8,20,11,31
MORO MORO,desnutricion aguda,desnutricion grave (g),2007-01-01,0,1,0,0,0,1,1
OCURI,desnutricion aguda,desnutricion grave (g),2007-01-01,3,2,1,2,4,4,8
OKINAWA,desnutricion aguda,desnutricion grave (g),2007-01-01,1,0,0,0,1,0,1
ORURO,desnutricion aguda,desnutricion grave (g),2007-01-01,11,10,1,1,12,11,23
PADILLA,desnutricion aguda,desnutricion grave (g),2007-01-01,2,0,1,2,3,2,5
PAMPA AULLAGAS,desnutricion aguda,desnutricion grave (g),2007-01-01,0,0,0,1,0,1,1
PAMPA GRANDE,desnutricion aguda,desnutricion grave (g),2007-01-01,0,0,0,1,0,1,1
POCOATA,desnutricion aguda,desnutricion grave (g),2007-01-01,1,4,0,2,1,6,7
POCONA,desnutricion aguda,desnutricion grave (g),2007-01-01,1,1,0,0,1,1,2
POJO (CBBA),desnutricion aguda,desnutricion grave (g),2007-01-01,1,1,0,0,1,1,2
PORCO,desnutricion aguda,desnutricion grave (g),2007-01-01,2,0,1,1,3,1,4
POROMA,desnutricion aguda,desnutricion grave (g),2007-01-01,3,0,0,0,3,0,3
PORTACHUELO,desnutricion aguda,desnutricion grave (g),2007-01-01,1,0,0,0,1,0,1
POTOSI,desnutricion aguda,desnutricion grave (g),2007-01-01,8,8,0,3,8,11,19
PRESTO,desnutricion aguda,desnutricion grave (g),2007-01-01,1,4,1,0,2,4,6
PUERTO GONZALO MORENO,desnutricion aguda,desnutricion grave (g),2007-01-01,2,1,1,0,3,1,4
PUERTO QUIJARRO,desnutricion aguda,desnutricion grave (g),2007-01-01,1,0,0,1,1,1,2
PUERTO SUAREZ,desnutricion aguda,desnutricion grave (g),2007-01-01,1,1,0,0,1,1,2
PUERTO VILLARROEL,desnutricion aguda,desnutricion grave (g),2007-01-01,1,5,7,2,8,7,15
PUNA,desnutricion aguda,desnutricion grave (g),2007-01-01,1,5,1,3,2,8,10
PUNATA,desnutricion aguda,desnutricion grave (g),2007-01-01,1,0,0,0,1,0,1
QUILLACOLLO,desnutricion aguda,desnutricion grave (g),2007-01-01,5,1,0,3,5,4,9
QUIME,desnutricion aguda,desnutricion grave (g),2007-01-01,3,2,0,0,3,2,5
RAVELO,desnutricion aguda,desnutricion grave (g),2007-01-01,5,1,3,4,8,5,13
REYES,desnutricion aguda,desnutricion grave (g),2007-01-01,2,2,0,0,2,2,4
RIBERALTA,desnutricion aguda,desnutricion grave (g),2007-01-01,14,16,6,7,20,23,43
ROBORE,desnutricion aguda,desnutricion grave (g),2007-01-01,1,1,0,0,1,1,2
RURRENABAQUE,desnutricion aguda,desnutricion grave (g),2007-01-01,2,0,0,0,2,0,2
SABAYA,desnutricion aguda,desnutricion grave (g),2007-01-01,0,1,0,0,0,1,1
SACABA,desnutricion aguda,desnutricion grave (g),2007-01-01,1,1,0,0,1,1,2
SACACA,desnutricion aguda,desnutricion grave (g),2007-01-01,4,1,1,2,5,3,8
SAIPINA,desnutricion aguda,desnutricion grave (g),2007-01-01,2,0,0,1,2,1,3
SAN AGUSTIN,desnutricion aguda,desnutricion grave (g),2007-01-01,1,0,0,0,1,0,1
SAN BENITO,desnutricion aguda,desnutricion grave (g),2007-01-01,0,1,0,0,0,1,1
SAN BORJA,desnutricion aguda,desnutricion grave (g),2007-01-01,1,2,0,1,1,3,4
SAN CARLOS,desnutricion aguda,desnutricion grave (g),2007-01-01,1,0,0,1,1,1,2
SAN IGNACIO,desnutricion aguda,desnutricion grave (g),2007-01-01,6,2,1,1,7,3,10
SAN IGNACIO DE VELASCO,desnutricion aguda,desnutricion grave (g),2007-01-01,5,1,3,2,8,3,11
SAN JOSE DE CHIQUITOS,desnutricion aguda,desnutricion grave (g),2007-01-01,0,0,0,2,0,2,2
SAN LORENZO(TJA),desnutricion aguda,desnutricion grave (g),2007-01-01,0,2,0,0,0,2,2
SAN LUCAS,desnutricion aguda,desnutricion grave (g),2007-01-01,0,1,2,1,2,2,4
SAN MATIAS,desnutricion aguda,desnutricion grave (g),2007-01-01,1,0,0,0,1,0,1
SAN RAFAEL,desnutricion aguda,desnutricion grave (g),2007-01-01,0,1,0,0,0,1,1
SANTA CRUZ DE LA SIERRA,desnutricion aguda,desnutricion grave (g),2007-01-01,24,21,3,15,27,36,63
SANTA ROSA,desnutricion aguda,desnutricion grave (g),2007-01-01,1,0,0,0,1,0,1
SANTA ROSA DEL SARA,desnutricion aguda,desnutricion grave (g),2007-01-01,0,1,2,0,2,1,3
SENA,desnutricion aguda,desnutricion grave (g),2007-01-01,1,0,0,0,1,0,1
SICAYA,desnutricion aguda,desnutricion grave (g),2007-01-01,0,2,0,0,0,2,2
SIPE SIPE,desnutricion aguda,desnutricion grave (g),2007-01-01,3,1,0,2,3,3,6
SOPACHUY,desnutricion aguda,desnutricion grave (g),2007-01-01,2,3,0,3,2,6,8
SUCRE,desnutricion aguda,desnutricion grave (g),2007-01-01,7,8,2,2,9,10,19
TACOBAMBA,desnutricion aguda,desnutricion grave (g),2007-01-01,1,1,0,0,1,1,2
TACOPAYA,desnutricion aguda,desnutricion grave (g),2007-01-01,0,0,1,1,1,1,2
TAPACARI,desnutricion aguda,desnutricion grave (g),2007-01-01,10,5,0,1,10,6,16
TARABUCO,desnutricion aguda,desnutricion grave (g),2007-01-01,10,7,4,3,14,10,24
TARATA,desnutricion aguda,desnutricion grave (g),2007-01-01,0,1,0,0,0,1,1
TARIJA,desnutricion aguda,desnutricion grave (g),2007-01-01,4,2,3,6,7,8,15
TARVITA,desnutricion aguda,desnutricion grave (g),2007-01-01,5,3,1,1,6,4,10
TINGUIPAYA,desnutricion aguda,desnutricion grave (g),2007-01-01,5,1,3,1,8,2,10
TIQUIPAYA,desnutricion aguda,desnutricion grave (g),2007-01-01,2,1,0,2,2,3,5
TIRAQUE (CBBA),desnutricion aguda,desnutricion grave (g),2007-01-01,4,5,2,4,6,9,15
TOMINA,desnutricion aguda,desnutricion grave (g),2007-01-01,2,0,1,5,3,5,8
TOTORA(CBBA),desnutricion aguda,desnutricion grave (g),2007-01-01,0,0,1,1,1,1,2
TOTORA(ORR),desnutricion aguda,desnutricion grave (g),2007-01-01,1,0,0,0,1,0,1
TRINIDAD,desnutricion aguda,desnutricion grave (g),2007-01-01,4,4,0,5,4,9,13
TUPIZA,desnutricion aguda,desnutricion grave (g),2007-01-01,3,1,1,3,4,4,8
URIONDO (A. CONCEPCION),desnutricion aguda,desnutricion grave (g),2007-01-01,0,0,1,0,1,0,1
VALLEGRANDE,desnutricion aguda,desnutricion grave (g),2007-01-01,1,1,0,0,1,1,2
VILLA MONTES,desnutricion aguda,desnutricion grave (g),2007-01-01,2,0,0,1,2,1,3
VILLA NUEVA (LOMA ALTA),desnutricion aguda,desnutricion grave (g),2007-01-01,0,1,1,2,1,3,4
VILLA SERRANO,desnutricion aguda,desnutricion grave (g),2007-01-01,0,3,0,1,0,4,4
VILLA TUNARI,desnutricion aguda,desnutricion grave (g),2007-01-01,4,9,4,2,8,11,19
VILLA VACA GUZMAN (MUYUPAMPA),desnutricion aguda,desnutricion grave (g),2007-01-01,0,0,2,0,2,0,2
VILLAZON,desnutricion aguda,desnutricion grave (g),2007-01-01,1,0,0,2,1,2,3
VITICHI,desnutricion aguda,desnutricion grave (g),2007-01-01,4,2,0,1,4,3,7
WARNES,desnutricion aguda,desnutricion grave (g),2007-01-01,2,1,4,1,6,2,8
YACUIBA,desnutricion aguda,desnutricion grave (g),2007-01-01,0,1,0,3,0,4,4
YAMPARAEZ,desnutricion aguda,desnutricion grave (g),2007-01-01,2,0,1,1,3,1,4
YAPACANI,desnutricion aguda,desnutricion grave (g),2007-01-01,4,2,0,1,4,3,7
YOCALLA,desnutricion aguda,desnutricion grave (g),2007-01-01,1,0,0,0,1,0,1
YOTALA,desnutricion aguda,desnutricion grave (g),2007-01-01,1,0,0,0,1,0,1
ZUDAÑEZ,desnutricion aguda,desnutricion grave (g),2007-01-01,0,1,3,0,3,1,4
AIQUILE,desnutricion aguda,desnutricion grave (g),2007-02-01,3,4,1,2,4,6,10
ALALAY,desnutricion aguda,desnutricion grave (g),2007-02-01,0,0,0,1,0,1,1
ALCALA,desnutricion aguda,desnutricion grave (g),2007-02-01,0,1,0,0,0,1,1
ANDAMARCA,desnutricion aguda,desnutricion grave (g),2007-02-01,1,0,0,0,1,0,1
ARAMPAMPA,desnutricion aguda,desnutricion grave (g),2007-02-01,3,1,5,4,8,5,13
ARANI,desnutricion aguda,desnutricion grave (g),2007-02-01,1,0,0,0,1,0,1
ARBIETO,desnutricion aguda,desnutricion grave (g),2007-02-01,0,0,1,2,1,2,3
ARQUE,desnutricion aguda,desnutricion grave (g),2007-02-01,2,5,0,0,2,5,7
ASCENCION DE GUARAYOS,desnutricion aguda,desnutricion grave (g),2007-02-01,5,4,1,2,6,6,12
AYOPAYA (V. DE INDEPENDENCIA),desnutricion aguda,desnutricion grave (g),2007-02-01,0,1,0,0,0,1,1
AZURDUY,desnutricion aguda,desnutricion grave (g),2007-02-01,1,2,0,3,1,5,6
BELEN DE ANDAMARCA,desnutricion aguda,desnutricion grave (g),2007-02-01,1,0,0,0,1,0,1
BERMEJO,desnutricion aguda,desnutricion grave (g),2007-02-01,0,1,0,0,0,1,1
BETANZOS,desnutricion aguda,desnutricion grave (g),2007-02-01,3,1,1,2,4,3,7
BOLIVAR,desnutricion aguda,desnutricion grave (g),2007-02-01,3,2,1,0,4,2,6
BOLPEBRA,desnutricion aguda,desnutricion grave (g),2007-02-01,0,0,1,0,1,0,1
CABEZAS,desnutricion aguda,desnutricion grave (g),2007-02-01,1,0,4,1,5,1,6
"CAIZA ""D""",desnutricion aguda,desnutricion grave (g),2007-02-01,0,2,1,0,1,2,3
CAJUATA,desnutricion aguda,desnutricion grave (g),2007-02-01,3,1,0,0,3,1,4
CAMARGO,desnutricion aguda,desnutricion grave (g),2007-02-01,3,3,0,0,3,3,6
CAMATAQUI (C. VILLA ABECIA),desnutricion aguda,desnutricion grave (g),2007-02-01,0,0,0,1,0,1,1
CAMIRI,desnutricion aguda,desnutricion grave (g),2007-02-01,2,2,0,5,2,7,9
CAPINOTA,desnutricion aguda,desnutricion grave (g),2007-02-01,5,1,2,0,7,1,8
CARAPARI,desnutricion aguda,desnutricion grave (g),2007-02-01,0,0,1,0,1,0,1
CARIPUYO,desnutricion aguda,desnutricion grave (g),2007-02-01,3,3,0,1,3,4,7
CARMEN RIVERO TORREZ,desnutricion aguda,desnutricion grave (g),2007-02-01,2,0,0,0,2,0,2
CHALLAPATA,desnutricion aguda,desnutricion grave (g),2007-02-01,2,2,1,0,3,2,5
CHAQUI,desnutricion aguda,desnutricion grave (g),2007-02-01,1,0,0,1,1,1,2
CHARAGUA,desnutricion aguda,desnutricion grave (g),2007-02-01,3,4,0,1,3,5,8
CHAYANTA,desnutricion aguda,desnutricion grave (g),2007-02-01,0,4,3,5,3,9,12
CHIMORE,desnutricion aguda,desnutricion grave (g),2007-02-01,2,3,1,0,3,3,6
CHIPAYA,desnutricion aguda,desnutricion grave (g),2007-02-01,1,0,0,0,1,0,1
CHOQUE COTA,desnutricion aguda,desnutricion grave (g),2007-02-01,1,0,0,0,1,0,1
COCHABAMBA,desnutricion aguda,desnutricion grave (g),2007-02-01,16,8,5,7,21,15,36
COLOMI,desnutricion aguda,desnutricion grave (g),2007-02-01,3,2,0,0,3,2,5
COLQUECHACA,desnutricion aguda,desnutricion grave (g),2007-02-01,1,3,0,3,1,6,7
COMARAPA,desnutricion aguda,desnutricion grave (g),2007-02-01,2,1,0,0,2,1,3
CONCEPCION,desnutricion aguda,desnutricion grave (g),2007-02-01,0,0,0,1,0,1,1
COTAGAITA,desnutricion aguda,desnutricion grave (g),2007-02-01,2,8,3,5,5,13,18
CUATRO CAÑADAS,desnutricion aguda,desnutricion grave (g),2007-02-01,0,0,0,1,0,1,1
CULPINA,desnutricion aguda,desnutricion grave (g),2007-02-01,7,2,0,0,7,2,9
EL PUENTE(TJA),desnutricion aguda,desnutricion grave (g),2007-02-01,1,0,0,0,1,0,1
EL VILLAR,desnutricion aguda,desnutricion grave (g),2007-02-01,0,2,0,1,0,3,3
ENTRE RIOS,desnutricion aguda,desnutricion grave (g),2007-02-01,2,1,2,2,4,3,7
GENERAL SAAVEDRA,desnutricion aguda,desnutricion grave (g),2007-02-01,0,1,0,0,0,1,1
GUAYARAMERIN,desnutricion aguda,desnutricion grave (g),2007-02-01,2,2,0,2,2,4,6
GUTIERREZ,desnutricion aguda,desnutricion grave (g),2007-02-01,0,4,0,0,0,4,4
HUACARETA,desnutricion aguda,desnutricion grave (g),2007-02-01,1,0,0,1,1,1,2
HUACAYA (VILLA DE HUACAYA),desnutricion aguda,desnutricion grave (g),2007-02-01,0,0,1,0,1,0,1
ICLA,desnutricion aguda,desnutricion grave (g),2007-02-01,6,3,1,4,7,7,14
INCAHUASI,desnutricion aguda,desnutricion grave (g),2007-02-01,2,4,2,0,4,4,8
INQUISIVI,desnutricion aguda,desnutricion grave (g),2007-02-01,4,1,1,0,5,1,6
LAGUNILLAS,desnutricion aguda,desnutricion grave (g),2007-02-01,1,0,0,0,1,0,1
LLALLAGUA,desnutricion aguda,desnutricion grave (g),2007-02-01,1,1,1,0,2,1,3
MINEROS,desnutricion aguda,desnutricion grave (g),2007-02-01,3,2,0,0,3,2,5
MIZQUE,desnutricion aguda,desnutricion grave (g),2007-02-01,4,3,0,2,4,5,9
MONTEAGUDO,desnutricion aguda,desnutricion grave (g),2007-02-01,2,4,2,1,4,5,9
MONTERO,desnutricion aguda,desnutricion grave (g),2007-02-01,3,2,0,1,3,3,6
OCURI,desnutricion aguda,desnutricion grave (g),2007-02-01,3,3,0,0,3,3,6
ORURO,desnutricion aguda,desnutricion grave (g),2007-02-01,11,10,5,4,16,14,30
PADILLA,desnutricion aguda,desnutricion grave (g),2007-02-01,0,2,2,0,2,2,4
PAILON,desnutricion aguda,desnutricion grave (g),2007-02-01,1,0,0,0,1,0,1
PASORAPA,desnutricion aguda,desnutricion grave (g),2007-02-01,0,0,0,2,0,2,2
POCOATA,desnutricion aguda,desnutricion grave (g),2007-02-01,0,2,0,2,0,4,4
POCONA,desnutricion aguda,desnutricion grave (g),2007-02-01,0,2,1,1,1,3,4
POJO (CBBA),desnutricion aguda,desnutricion grave (g),2007-02-01,0,1,1,0,1,1,2
POROMA,desnutricion aguda,desnutricion grave (g),2007-02-01,1,2,0,5,1,7,8
PORTACHUELO,desnutricion aguda,desnutricion grave (g),2007-02-01,0,2,0,0,0,2,2
PORVENIR,desnutricion aguda,desnutricion grave (g),2007-02-01,0,4,0,0,0,4,4
POSTRER VALLE,desnutricion aguda,desnutricion grave (g),2007-02-01,0,0,0,2,0,2,2
POTOSI,desnutricion aguda,desnutricion grave (g),2007-02-01,10,12,0,2,10,14,24
PRESTO,desnutricion aguda,desnutricion grave (g),2007-02-01,6,1,1,0,7,1,8
PUERTO GONZALO MORENO,desnutricion aguda,desnutricion grave (g),2007-02-01,2,0,1,0,3,0,3
PUERTO SUAREZ,desnutricion aguda,desnutricion grave (g),2007-02-01,2,0,0,0,2,0,2
PUERTO VILLARROEL,desnutricion aguda,desnutricion grave (g),2007-02-01,8,5,5,4,13,9,22
PUNA,desnutricion aguda,desnutricion grave (g),2007-02-01,2,3,2,3,4,6,10
QUILLACOLLO,desnutricion aguda,desnutricion grave (g),2007-02-01,4,2,1,0,5,2,7
QUIME,desnutricion aguda,desnutricion grave (g),2007-02-01,1,1,0,0,1,1,2
RAVELO,desnutricion aguda,desnutricion grave (g),2007-02-01,7,3,0,1,7,4,11
REYES,desnutricion aguda,desnutricion grave (g),2007-02-01,17,23,3,3,20,26,46
RIBERALTA,desnutricion aguda,desnutricion grave (g),2007-02-01,4,20,6,1,10,21,31
ROBORE,desnutricion aguda,desnutricion grave (g),2007-02-01,1,1,0,0,1,1,2
RURRENABAQUE,desnutricion aguda,desnutricion grave (g),2007-02-01,0,1,0,0,0,1,1
SABAYA,desnutricion aguda,desnutricion grave (g),2007-02-01,0,1,0,0,0,1,1
SACABA,desnutricion aguda,desnutricion grave (g),2007-02-01,0,1,0,0,0,1,1
SACABAMBA,desnutricion aguda,desnutricion grave (g),2007-02-01,2,0,0,0,2,0,2
SACACA,desnutricion aguda,desnutricion grave (g),2007-02-01,9,6,2,8,11,14,25
SALINAS DE GARCI MENDOZA,desnutricion aguda,desnutricion grave (g),2007-02-01,0,0,0,1,0,1,1
SAN ANTONIO DE LOMERIO,desnutricion aguda,desnutricion grave (g),2007-02-01,2,0,1,0,3,0,3
SAN BENITO,desnutricion aguda,desnutricion grave (g),2007-02-01,0,0,2,0,2,0,2
SAN BORJA,desnutricion aguda,desnutricion grave (g),2007-02-01,3,1,0,0,3,1,4
SAN CARLOS,desnutricion aguda,desnutricion grave (g),2007-02-01,1,0,0,1,1,1,2
SAN IGNACIO,desnutricion aguda,desnutricion grave (g),2007-02-01,2,4,1,1,3,5,8
SAN IGNACIO DE VELASCO,desnutricion aguda,desnutricion grave (g),2007-02-01,2,4,3,2,5,6,11
SAN JAVIER(BNI),desnutricion aguda,desnutricion grave (g),2007-02-01,1,0,0,0,1,0,1
SAN JOSE DE CHIQUITOS,desnutricion aguda,desnutricion grave (g),2007-02-01,0,0,0,1,0,1,1
SAN JUAN DE YAPACANI,desnutricion aguda,desnutricion grave (g),2007-02-01,1,0,0,0,1,0,1
SAN LUCAS,desnutricion aguda,desnutricion grave (g),2007-02-01,4,3,3,3,7,6,13
SAN MATIAS,desnutricion aguda,desnutricion grave (g),2007-02-01,0,0,1,1,1,1,2
SAN PEDRO,desnutricion aguda,desnutricion grave (g),2007-02-01,0,2,0,0,0,2,2
SAN PEDRO(PND),desnutricion aguda,desnutricion grave (g),2007-02-01,0,0,1,0,1,0,1
SAN RAFAEL,desnutricion aguda,desnutricion grave (g),2007-02-01,0,0,1,0,1,0,1
SANTA ANA,desnutricion aguda,desnutricion grave (g),2007-02-01,0,2,0,0,0,2,2
SANTA CRUZ DE LA SIERRA,desnutricion aguda,desnutricion grave (g),2007-02-01,13,14,5,8,18,22,40
SANTA ROSA,desnutricion aguda,desnutricion grave (g),2007-02-01,1,1,0,0,1,1,2
SANTA ROSA DEL SARA,desnutricion aguda,desnutricion grave (g),2007-02-01,0,0,0,1,0,1,1
SANTIAGO DE HUARI,desnutricion aguda,desnutricion grave (g),2007-02-01,1,0,0,0,1,0,1
SANTIVAÑES,desnutricion aguda,desnutricion grave (g),2007-02-01,0,1,3,0,3,1,4
SIPE SIPE,desnutricion aguda,desnutricion grave (g),2007-02-01,0,0,1,1,1,1,2
SOPACHUY,desnutricion aguda,desnutricion grave (g),2007-02-01,3,2,1,2,4,4,8
SORACACHI,desnutricion aguda,desnutricion grave (g),2007-02-01,2,0,0,0,2,0,2
SUCRE,desnutricion aguda,desnutricion grave (g),2007-02-01,8,8,2,2,10,10,20
TACOBAMBA,desnutricion aguda,desnutricion grave (g),2007-02-01,3,6,2,1,5,7,12
TACOPAYA,desnutricion aguda,desnutricion grave (g),2007-02-01,0,1,0,1,0,2,2
TAPACARI,desnutricion aguda,desnutricion grave (g),2007-02-01,12,9,1,0,13,9,22
TARABUCO,desnutricion aguda,desnutricion grave (g),2007-02-01,11,6,2,7,13,13,26
TARATA,desnutricion aguda,desnutricion grave (g),2007-02-01,0,1,0,0,0,1,1
TARIJA,desnutricion aguda,desnutricion grave (g),2007-02-01,4,6,2,4,6,10,16
TARVITA,desnutricion aguda,desnutricion grave (g),2007-02-01,1,3,0,0,1,3,4
TINGUIPAYA,desnutricion aguda,desnutricion grave (g),2007-02-01,3,2,1,2,4,4,8
TIQUIPAYA,desnutricion aguda,desnutricion grave (g),2007-02-01,1,2,1,2,2,4,6
TIRAQUE (CBBA),desnutricion aguda,desnutricion grave (g),2007-02-01,3,8,0,1,3,9,12
TOMAVE,desnutricion aguda,desnutricion grave (g),2007-02-01,0,2,1,0,1,2,3
TOMINA,desnutricion aguda,desnutricion grave (g),2007-02-01,3,1,0,5,3,6,9
TORO TORO,desnutricion aguda,desnutricion grave (g),2007-02-01,4,1,0,1,4,2,6
TOTORA(CBBA),desnutricion aguda,desnutricion grave (g),2007-02-01,0,0,1,0,1,0,1
TRINIDAD,desnutricion aguda,desnutricion grave (g),2007-02-01,1,1,2,2,3,3,6
TUPIZA,desnutricion aguda,desnutricion grave (g),2007-02-01,1,1,1,1,2,2,4
UNCIA,desnutricion aguda,desnutricion grave (g),2007-02-01,1,0,0,0,1,0,1
URUBICHA,desnutricion aguda,desnutricion grave (g),2007-02-01,1,1,2,4,3,5,8
VACAS,desnutricion aguda,desnutricion grave (g),2007-02-01,0,0,0,1,0,1,1
VALLEGRANDE,desnutricion aguda,desnutricion grave (g),2007-02-01,0,0,0,2,0,2,2
VILLA MONTES,desnutricion aguda,desnutricion grave (g),2007-02-01,0,0,1,0,1,0,1
VILLA SERRANO,desnutricion aguda,desnutricion grave (g),2007-02-01,0,0,0,1,0,1,1
VILLA TUNARI,desnutricion aguda,desnutricion grave (g),2007-02-01,6,7,1,3,7,10,17
VITICHI,desnutricion aguda,desnutricion grave (g),2007-02-01,1,4,2,0,3,4,7
WARNES,desnutricion aguda,desnutricion grave (g),2007-02-01,0,5,0,1,0,6,6
YACUIBA,desnutricion aguda,desnutricion grave (g),2007-02-01,1,0,1,0,2,0,2
YAMPARAEZ,desnutricion aguda,desnutricion grave (g),2007-02-01,3,0,1,1,4,1,5
YAPACANI,desnutricion aguda,desnutricion grave (g),2007-02-01,4,4,1,2,5,6,11
YOTALA,desnutricion aguda,desnutricion grave (g),2007-02-01,0,1,1,0,1,1,2
ZUDAÑEZ,desnutricion aguda,desnutricion grave (g),2007-02-01,1,1,2,2,3,3,6
ACACIO,desnutricion aguda,desnutricion grave (g),2007-03-01,0,0,0,2,0,2,2
AIQUILE,desnutricion aguda,desnutricion grave (g),2007-03-01,5,4,1,1,6,5,11
ALALAY,desnutricion aguda,desnutricion grave (g),2007-03-01,1,0,0,0,1,0,1
ALCALA,desnutricion aguda,desnutricion grave (g),2007-03-01,0,0,1,1,1,1,2
ANDAMARCA,desnutricion aguda,desnutricion grave (g),2007-03-01,0,0,0,1,0,1,1
ANTEQUERA,desnutricion aguda,desnutricion grave (g),2007-03-01,1,2,1,0,2,2,4
ANZALDO,desnutricion aguda,desnutricion grave (g),2007-03-01,2,1,0,1,2,2,4
ARAMPAMPA,desnutricion aguda,desnutricion grave (g),2007-03-01,5,2,7,0,12,2,14
ARANI,desnutricion aguda,desnutricion grave (g),2007-03-01,2,0,1,1,3,1,4
ARBIETO,desnutricion aguda,desnutricion grave (g),2007-03-01,1,0,0,1,1,1,2
ARQUE,desnutricion aguda,desnutricion grave (g),2007-03-01,3,2,2,1,5,3,8
ATOCHA,desnutricion aguda,desnutricion grave (g),2007-03-01,2,0,0,0,2,0,2
AYOPAYA (V. DE INDEPENDENCIA),desnutricion aguda,desnutricion grave (g),2007-03-01,1,0,0,0,1,0,1
AZURDUY,desnutricion aguda,desnutricion grave (g),2007-03-01,1,4,0,6,1,10,11
BELEN DE URMIRI,desnutricion aguda,desnutricion grave (g),2007-03-01,0,2,0,2,0,4,4
BERMEJO,desnutricion aguda,desnutricion grave (g),2007-03-01,0,0,0,1,0,1,1
BETANZOS,desnutricion aguda,desnutricion grave (g),2007-03-01,5,9,1,6,6,15,21
BOLIVAR,desnutricion aguda,desnutricion grave (g),2007-03-01,2,5,0,4,2,9,11
BUENA VISTA,desnutricion aguda,desnutricion grave (g),2007-03-01,1,1,0,0,1,1,2
CABEZAS,desnutricion aguda,desnutricion grave (g),2007-03-01,0,3,0,0,0,3,3
"CAIZA ""D""",desnutricion aguda,desnutricion grave (g),2007-03-01,0,1,0,2,0,3,3
CAJUATA,desnutricion aguda,desnutricion grave (g),2007-03-01,5,0,0,0,5,0,5
CAMARGO,desnutricion aguda,desnutricion grave (g),2007-03-01,2,2,0,3,2,5,7
CAMATAQUI (C. VILLA ABECIA),desnutricion aguda,desnutricion grave (g),2007-03-01,1,0,0,1,1,1,2
CAMIRI,desnutricion aguda,desnutricion grave (g),2007-03-01,8,3,0,1,8,4,12
CAPINOTA,desnutricion aguda,desnutricion grave (g),2007-03-01,7,11,7,5,14,16,30
CARACOLLO,desnutricion aguda,desnutricion grave (g),2007-03-01,0,1,0,0,0,1,1
CARIPUYO,desnutricion aguda,desnutricion grave (g),2007-03-01,7,5,2,3,9,8,17
CARMEN RIVERO TORREZ,desnutricion aguda,desnutricion grave (g),2007-03-01,1,4,0,0,1,4,5
CHALLAPATA,desnutricion aguda,desnutricion grave (g),2007-03-01,3,1,0,0,3,1,4
CHAQUI,desnutricion aguda,desnutricion grave (g),2007-03-01,0,1,0,0,0,1,1
CHARAGUA,desnutricion aguda,desnutricion grave (g),2007-03-01,1,1,0,0,1,1,2
CHAYANTA,desnutricion aguda,desnutricion grave (g),2007-03-01,2,1,0,0,2,1,3
CHIMORE,desnutricion aguda,desnutricion grave (g),2007-03-01,2,5,1,2,3,7,10
COBIJA,desnutricion aguda,desnutricion grave (g),2007-03-01,2,0,1,0,3,0,3
COCHABAMBA,desnutricion aguda,desnutricion grave (g),2007-03-01,9,12,8,2,17,14,31
COLOMI,desnutricion aguda,desnutricion grave (g),2007-03-01,2,0,0,1,2,1,3
COLQUECHACA,desnutricion aguda,desnutricion grave (g),2007-03-01,8,10,3,3,11,13,24
COLQUIRI,desnutricion aguda,desnutricion grave (g),2007-03-01,0,0,2,0,2,0,2
COMARAPA,desnutricion aguda,desnutricion grave (g),2007-03-01,0,1,0,0,0,1,1
CONCEPCION,desnutricion aguda,desnutricion grave (g),2007-03-01,1,0,0,0,1,0,1
COTAGAITA,desnutricion aguda,desnutricion grave (g),2007-03-01,3,4,1,0,4,4,8
CUEVO,desnutricion aguda,desnutricion grave (g),2007-03-01,1,1,0,0,1,1,2
CULPINA,desnutricion aguda,desnutricion grave (g),2007-03-01,3,2,0,2,3,4,7
EL PUENTE(STC),desnutricion aguda,desnutricion grave (g),2007-03-01,0,0,0,1,0,1,1
EL VILLAR,desnutricion aguda,desnutricion grave (g),2007-03-01,1,1,0,0,1,1,2
ENTRE RIOS,desnutricion aguda,desnutricion grave (g),2007-03-01,2,2,3,4,5,6,11
ENTRE RIOS,desnutricion aguda,desnutricion grave (g),2007-03-01,0,0,1,0,1,0,1
ESCARA,desnutricion aguda,desnutricion grave (g),2007-03-01,1,0,0,0,1,0,1
EUCALIPTUS,desnutricion aguda,desnutricion grave (g),2007-03-01,1,1,0,0,1,1,2
FERNANDEZ ALONSO,desnutricion aguda,desnutricion grave (g),2007-03-01,0,0,0,2,0,2,2
GENERAL SAAVEDRA,desnutricion aguda,desnutricion grave (g),2007-03-01,0,2,0,1,0,3,3
GUAYARAMERIN,desnutricion aguda,desnutricion grave (g),2007-03-01,2,1,1,2,3,3,6
HUACARETA,desnutricion aguda,desnutricion grave (g),2007-03-01,0,0,0,2,0,2,2
ICLA,desnutricion aguda,desnutricion grave (g),2007-03-01,4,6,1,4,5,10,15
INCAHUASI,desnutricion aguda,desnutricion grave (g),2007-03-01,7,6,0,0,7,6,13
LAGUNILLAS,desnutricion aguda,desnutricion grave (g),2007-03-01,0,1,1,0,1,1,2
LLALLAGUA,desnutricion aguda,desnutricion grave (g),2007-03-01,2,1,0,0,2,1,3
MACHACAMARCA,desnutricion aguda,desnutricion grave (g),2007-03-01,1,1,0,0,1,1,2
MACHARETI,desnutricion aguda,desnutricion grave (g),2007-03-01,1,0,1,0,2,0,2
MINEROS,desnutricion aguda,desnutricion grave (g),2007-03-01,2,4,0,1,2,5,7
MIZQUE,desnutricion aguda,desnutricion grave (g),2007-03-01,3,5,0,0,3,5,8
MONTEAGUDO,desnutricion aguda,desnutricion grave (g),2007-03-01,2,3,3,0,5,3,8
MONTERO,desnutricion aguda,desnutricion grave (g),2007-03-01,3,8,3,3,6,11,17
MOROCHATA,desnutricion aguda,desnutricion grave (g),2007-03-01,3,1,1,3,4,4,8
OCURI,desnutricion aguda,desnutricion grave (g),2007-03-01,2,3,2,4,4,7,11
OKINAWA,desnutricion aguda,desnutricion grave (g),2007-03-01,2,0,0,0,2,0,2
ORURO,desnutricion aguda,desnutricion grave (g),2007-03-01,4,6,2,1,6,7,13
PADILLA,desnutricion aguda,desnutricion grave (g),2007-03-01,0,1,2,2,2,3,5
PAILON,desnutricion aguda,desnutricion grave (g),2007-03-01,1,1,0,0,1,1,2
PAMPA GRANDE,desnutricion aguda,desnutricion grave (g),2007-03-01,0,1,0,0,0,1,1
POCOATA,desnutricion aguda,desnutricion grave (g),2007-03-01,0,7,0,3,0,10,10
POCONA,desnutricion aguda,desnutricion grave (g),2007-03-01,0,1,0,0,0,1,1
POJO (CBBA),desnutricion aguda,desnutricion grave (g),2007-03-01,2,0,1,0,3,0,3
PORCO,desnutricion aguda,desnutricion grave (g),2007-03-01,0,0,0,1,0,1,1
POROMA,desnutricion aguda,desnutricion grave (g),2007-03-01,7,7,1,3,8,10,18
PORTACHUELO,desnutricion aguda,desnutricion grave (g),2007-03-01,1,0,0,0,1,0,1
POTOSI,desnutricion aguda,desnutricion grave (g),2007-03-01,8,13,3,6,11,19,30
PRESTO,desnutricion aguda,desnutricion grave (g),2007-03-01,3,1,0,1,3,2,5
PUERTO GONZALO MORENO,desnutricion aguda,desnutricion grave (g),2007-03-01,2,0,1,0,3,0,3
PUERTO QUIJARRO,desnutricion aguda,desnutricion grave (g),2007-03-01,0,2,0,0,0,2,2
PUERTO SILES,desnutricion aguda,desnutricion grave (g),2007-03-01,0,1,0,0,0,1,1
PUERTO SUAREZ,desnutricion aguda,desnutricion grave (g),2007-03-01,1,1,0,0,1,1,2
PUERTO VILLARROEL,desnutricion aguda,desnutricion grave (g),2007-03-01,4,5,7,2,11,7,18
PUNA,desnutricion aguda,desnutricion grave (g),2007-03-01,6,8,0,1,6,9,15
PUNATA,desnutricion aguda,desnutricion grave (g),2007-03-01,0,0,2,2,2,2,4
QUILLACOLLO,desnutricion aguda,desnutricion grave (g),2007-03-01,8,3,1,1,9,4,13
RAVELO,desnutricion aguda,desnutricion grave (g),2007-03-01,11,8,4,6,15,14,29
REYES,desnutricion aguda,desnutricion grave (g),2007-03-01,0,0,0,1,0,1,1
RIBERALTA,desnutricion aguda,desnutricion grave (g),2007-03-01,5,27,3,6,8,33,41
ROBORE,desnutricion aguda,desnutricion grave (g),2007-03-01,2,0,0,1,2,1,3
RURRENABAQUE,desnutricion aguda,desnutricion grave (g),2007-03-01,1,2,0,0,1,2,3
SACABA,desnutricion aguda,desnutricion grave (g),2007-03-01,4,6,1,1,5,7,12
SACACA,desnutricion aguda,desnutricion grave (g),2007-03-01,6,9,1,4,7,13,20
SAIPINA,desnutricion aguda,desnutricion grave (g),2007-03-01,1,0,0,0,1,0,1
SAMAIPATA,desnutricion aguda,desnutricion grave (g),2007-03-01,1,0,0,0,1,0,1
SAN ANDRES,desnutricion aguda,desnutricion grave (g),2007-03-01,1,0,0,0,1,0,1
SAN ANTONIO DE ESMORUCO,desnutricion aguda,desnutricion grave (g),2007-03-01,0,0,0,1,0,1,1
SAN ANTONIO DE LOMERIO,desnutricion aguda,desnutricion grave (g),2007-03-01,3,0,1,3,4,3,7
SAN BENITO,desnutricion aguda,desnutricion grave (g),2007-03-01,1,0,1,0,2,0,2
SAN BORJA,desnutricion aguda,desnutricion grave (g),2007-03-01,2,1,0,3,2,4,6
SAN CARLOS,desnutricion aguda,desnutricion grave (g),2007-03-01,3,0,0,0,3,0,3
SAN IGNACIO,desnutricion aguda,desnutricion grave (g),2007-03-01,3,3,1,0,4,3,7
SAN IGNACIO DE VELASCO,desnutricion aguda,desnutricion grave (g),2007-03-01,11,10,1,3,12,13,25
SAN JOSE DE CHIQUITOS,desnutricion aguda,desnutricion grave (g),2007-03-01,1,2,1,0,2,2,4
SAN JULIAN,desnutricion aguda,desnutricion grave (g),2007-03-01,0,0,1,0,1,0,1
SAN LORENZO(TJA),desnutricion aguda,desnutricion grave (g),2007-03-01,1,0,3,0,4,0,4
SAN LUCAS,desnutricion aguda,desnutricion grave (g),2007-03-01,11,6,6,2,17,8,25
SAN MATIAS,desnutricion aguda,desnutricion grave (g),2007-03-01,1,1,0,0,1,1,2
SAN PABLO DE LIPEZ,desnutricion aguda,desnutricion grave (g),2007-03-01,0,1,0,0,0,1,1
SAN PEDRO,desnutricion aguda,desnutricion grave (g),2007-03-01,1,2,0,0,1,2,3
SANTA CRUZ DE LA SIERRA,desnutricion aguda,desnutricion grave (g),2007-03-01,20,34,6,9,26,43,69
SANTA ROSA,desnutricion aguda,desnutricion grave (g),2007-03-01,0,3,0,0,0,3,3
SANTIAGO DE HUARI,desnutricion aguda,desnutricion grave (g),2007-03-01,0,0,1,1,1,1,2
SANTIVAÑES,desnutricion aguda,desnutricion grave (g),2007-03-01,0,0,1,1,1,1,2
SENA,desnutricion aguda,desnutricion grave (g),2007-03-01,0,1,0,0,0,1,1
SICAYA,desnutricion aguda,desnutricion grave (g),2007-03-01,3,0,0,0,3,0,3
SIPE SIPE,desnutricion aguda,desnutricion grave (g),2007-03-01,2,3,0,0,2,3,5
SOPACHUY,desnutricion aguda,desnutricion grave (g),2007-03-01,4,7,2,3,6,10,16
SUCRE,desnutricion aguda,desnutricion grave (g),2007-03-01,12,10,2,1,14,11,25
TACOBAMBA,desnutricion aguda,desnutricion grave (g),2007-03-01,5,2,1,1,6,3,9
TACOPAYA,desnutricion aguda,desnutricion grave (g),2007-03-01,1,0,1,0,2,0,2
TAPACARI,desnutricion aguda,desnutricion grave (g),2007-03-01,6,5,4,4,10,9,19
TARABUCO,desnutricion aguda,desnutricion grave (g),2007-03-01,14,6,3,7,17,13,30
TARATA,desnutricion aguda,desnutricion grave (g),2007-03-01,0,1,0,1,0,2,2
TARIJA,desnutricion aguda,desnutricion grave (g),2007-03-01,9,2,2,2,11,4,15
TARVITA,desnutricion aguda,desnutricion grave (g),2007-03-01,3,6,2,1,5,7,12
TINGUIPAYA,desnutricion aguda,desnutricion grave (g),2007-03-01,10,3,2,2,12,5,17
TIQUIPAYA,desnutricion aguda,desnutricion grave (g),2007-03-01,0,0,1,0,1,0,1
TIRAQUE (CBBA),desnutricion aguda,desnutricion grave (g),2007-03-01,3,1,3,1,6,2,8
TOMAVE,desnutricion aguda,desnutricion grave (g),2007-03-01,1,1,0,1,1,2,3
TOMINA,desnutricion aguda,desnutricion grave (g),2007-03-01,7,3,1,3,8,6,14
TORO TORO,desnutricion aguda,desnutricion grave (g),2007-03-01,2,0,1,2,3,2,5
TOTORA(CBBA),desnutricion aguda,desnutricion grave (g),2007-03-01,1,2,0,0,1,2,3
TRINIDAD,desnutricion aguda,desnutricion grave (g),2007-03-01,2,0,0,0,2,0,2
TUPIZA,desnutricion aguda,desnutricion grave (g),2007-03-01,2,1,0,0,2,1,3
UNCIA,desnutricion aguda,desnutricion grave (g),2007-03-01,2,3,1,1,3,4,7
URIONDO (A. CONCEPCION),desnutricion aguda,desnutricion grave (g),2007-03-01,1,0,1,0,2,0,2
UYUNI,desnutricion aguda,desnutricion grave (g),2007-03-01,0,0,1,0,1,0,1
VALLEGRANDE,desnutricion aguda,desnutricion grave (g),2007-03-01,1,1,0,1,1,2,3
VILA VILA,desnutricion aguda,desnutricion grave (g),2007-03-01,0,1,0,0,0,1,1
VILLA MONTES,desnutricion aguda,desnutricion grave (g),2007-03-01,1,2,0,2,1,4,5
VILLA SERRANO,desnutricion aguda,desnutricion grave (g),2007-03-01,0,1,0,2,0,3,3
VILLA TUNARI,desnutricion aguda,desnutricion grave (g),2007-03-01,8,8,5,7,13,15,28
VILLA VACA GUZMAN (MUYUPAMPA),desnutricion aguda,desnutricion grave (g),2007-03-01,1,0,0,0,1,0,1
VILLAZON,desnutricion aguda,desnutricion grave (g),2007-03-01,0,1,0,0,0,1,1
VITICHI,desnutricion aguda,desnutricion grave (g),2007-03-01,5,1,1,0,6,1,7
WARNES,desnutricion aguda,desnutricion grave (g),2007-03-01,2,0,2,1,4,1,5
YACUIBA,desnutricion aguda,desnutricion grave (g),2007-03-01,0,2,1,0,1,2,3
YAMPARAEZ,desnutricion aguda,desnutricion grave (g),2007-03-01,2,0,3,1,5,1,6
YAPACANI,desnutricion aguda,desnutricion grave (g),2007-03-01,4,1,0,0,4,1,5
YOCALLA,desnutricion aguda,desnutricion grave (g),2007-03-01,0,0,0,1,0,1,1
YOTALA,desnutricion aguda,desnutricion grave (g),2007-03-01,0,0,0,1,0,1,1
ZUDAÑEZ,desnutricion aguda,desnutricion grave (g),2007-03-01,2,0,2,0,4,0,4
ACACIO,desnutricion aguda,desnutricion grave (g),2007-04-01,4,3,4,0,8,3,11
AIQUILE,desnutricion aguda,desnutricion grave (g),2007-04-01,1,3,2,2,3,5,8
ALCALA,desnutricion aguda,desnutricion grave (g),2007-04-01,0,1,0,0,0,1,1
ANDAMARCA,desnutricion aguda,desnutricion grave (g),2007-04-01,1,0,0,0,1,0,1
ARAMPAMPA,desnutricion aguda,desnutricion grave (g),2007-04-01,4,3,2,6,6,9,15
ARBIETO,desnutricion aguda,desnutricion grave (g),2007-04-01,1,0,0,0,1,0,1
ARQUE,desnutricion aguda,desnutricion grave (g),2007-04-01,2,1,0,0,2,1,3
ASCENCION DE GUARAYOS,desnutricion aguda,desnutricion grave (g),2007-04-01,6,1,1,5,7,6,13
ATOCHA,desnutricion aguda,desnutricion grave (g),2007-04-01,0,1,0,0,0,1,1
AYOPAYA (V. DE INDEPENDENCIA),desnutricion aguda,desnutricion grave (g),2007-04-01,4,2,2,2,6,4,10
AZURDUY,desnutricion aguda,desnutricion grave (g),2007-04-01,3,2,3,9,6,11,17
BELLA FLOR,desnutricion aguda,desnutricion grave (g),2007-04-01,1,1,0,0,1,1,2
BERMEJO,desnutricion aguda,desnutricion grave (g),2007-04-01,1,1,0,0,1,1,2
BETANZOS,desnutricion aguda,desnutricion grave (g),2007-04-01,7,10,4,2,11,12,23
BOYUIBE,desnutricion aguda,desnutricion grave (g),2007-04-01,1,0,0,0,1,0,1
CABEZAS,desnutricion aguda,desnutricion grave (g),2007-04-01,0,1,1,1,1,2,3
"CAIZA ""D""",desnutricion aguda,desnutricion grave (g),2007-04-01,0,1,0,0,0,1,1
CAJUATA,desnutricion aguda,desnutricion grave (g),2007-04-01,1,0,0,0,1,0,1
CAMARGO,desnutricion aguda,desnutricion grave (g),2007-04-01,2,2,0,3,2,5,7
CAMATAQUI (C. VILLA ABECIA),desnutricion aguda,desnutricion grave (g),2007-04-01,0,0,0,1,0,1,1
CAMIRI,desnutricion aguda,desnutricion grave (g),2007-04-01,2,1,0,0,2,1,3
CAPINOTA,desnutricion aguda,desnutricion grave (g),2007-04-01,7,3,10,1,17,4,21
CARIPUYO,desnutricion aguda,desnutricion grave (g),2007-04-01,2,2,4,2,6,4,10
CARMEN RIVERO TORREZ,desnutricion aguda,desnutricion grave (g),2007-04-01,1,0,0,0,1,0,1
CHALLAPATA,desnutricion aguda,desnutricion grave (g),2007-04-01,0,1,1,0,1,1,2
CHAQUI,desnutricion aguda,desnutricion grave (g),2007-04-01,1,0,1,1,2,1,3
CHAYANTA,desnutricion aguda,desnutricion grave (g),2007-04-01,0,1,0,1,0,2,2
CHIMORE,desnutricion aguda,desnutricion grave (g),2007-04-01,0,0,0,1,0,1,1
COBIJA,desnutricion aguda,desnutricion grave (g),2007-04-01,1,0,1,0,2,0,2
COCHABAMBA,desnutricion aguda,desnutricion grave (g),2007-04-01,11,9,1,1,12,10,22
COLCAPIRHUA,desnutricion aguda,desnutricion grave (g),2007-04-01,0,2,0,0,0,2,2
"COLCHA ""K""",desnutricion aguda,desnutricion grave (g),2007-04-01,0,0,1,0,1,0,1
COLOMI,desnutricion aguda,desnutricion grave (g),2007-04-01,3,0,0,2,3,2,5
COLQUECHACA,desnutricion aguda,desnutricion grave (g),2007-04-01,1,4,2,8,3,12,15
CONCEPCION,desnutricion aguda,desnutricion grave (g),2007-04-01,1,1,0,0,1,1,2
COTAGAITA,desnutricion aguda,desnutricion grave (g),2007-04-01,2,7,1,2,3,9,12
COTOCA,desnutricion aguda,desnutricion grave (g),2007-04-01,0,4,0,0,0,4,4
CUEVO,desnutricion aguda,desnutricion grave (g),2007-04-01,2,0,0,0,2,0,2
CULPINA,desnutricion aguda,desnutricion grave (g),2007-04-01,2,2,1,0,3,2,5
EL PUENTE(STC),desnutricion aguda,desnutricion grave (g),2007-04-01,1,0,0,0,1,0,1
EL TORNO,desnutricion aguda,desnutricion grave (g),2007-04-01,0,1,0,0,0,1,1
EL VILLAR,desnutricion aguda,desnutricion grave (g),2007-04-01,0,1,0,0,0,1,1
ENTRE RIOS,desnutricion aguda,desnutricion grave (g),2007-04-01,5,1,0,0,5,1,6
ENTRE RIOS,desnutricion aguda,desnutricion grave (g),2007-04-01,0,0,0,1,0,1,1
EXALTACION,desnutricion aguda,desnutricion grave (g),2007-04-01,1,0,0,0,1,0,1
FERNANDEZ ALONSO,desnutricion aguda,desnutricion grave (g),2007-04-01,1,0,1,0,2,0,2
GENERAL SAAVEDRA,desnutricion aguda,desnutricion grave (g),2007-04-01,1,0,0,0,1,0,1
GUAYARAMERIN,desnutricion aguda,desnutricion grave (g),2007-04-01,1,0,0,0,1,0,1
GUTIERREZ,desnutricion aguda,desnutricion grave (g),2007-04-01,0,1,0,0,0,1,1
HUACARETA,desnutricion aguda,desnutricion grave (g),2007-04-01,1,0,0,2,1,2,3
ICHOCA,desnutricion aguda,desnutricion grave (g),2007-04-01,2,0,0,0,2,0,2
ICLA,desnutricion aguda,desnutricion grave (g),2007-04-01,3,11,13,1,16,12,28
INCAHUASI,desnutricion aguda,desnutricion grave (g),2007-04-01,3,3,1,3,4,6,10
INQUISIVI,desnutricion aguda,desnutricion grave (g),2007-04-01,6,0,0,0,6,0,6
LAGUNILLAS,desnutricion aguda,desnutricion grave (g),2007-04-01,0,0,0,1,0,1,1
LLALLAGUA,desnutricion aguda,desnutricion grave (g),2007-04-01,2,1,2,5,4,6,10
LLICA,desnutricion aguda,desnutricion grave (g),2007-04-01,1,1,0,0,1,1,2
MACHARETI,desnutricion aguda,desnutricion grave (g),2007-04-01,0,1,0,0,0,1,1
MAGDALENA,desnutricion aguda,desnutricion grave (g),2007-04-01,0,0,0,1,0,1,1
MINEROS,desnutricion aguda,desnutricion grave (g),2007-04-01,1,3,0,0,1,3,4
MIZQUE,desnutricion aguda,desnutricion grave (g),2007-04-01,1,5,0,4,1,9,10
MOJOCOYA,desnutricion aguda,desnutricion grave (g),2007-04-01,0,1,0,0,0,1,1
MONTEAGUDO,desnutricion aguda,desnutricion grave (g),2007-04-01,1,2,3,2,4,4,8
MONTERO,desnutricion aguda,desnutricion grave (g),2007-04-01,2,9,0,3,2,12,14
MOROCHATA,desnutricion aguda,desnutricion grave (g),2007-04-01,0,1,1,1,1,2,3
OCURI,desnutricion aguda,desnutricion grave (g),2007-04-01,1,1,0,1,1,2,3
OKINAWA,desnutricion aguda,desnutricion grave (g),2007-04-01,2,0,0,0,2,0,2
ORURO,desnutricion aguda,desnutricion grave (g),2007-04-01,2,1,2,1,4,2,6
PADCAYA,desnutricion aguda,desnutricion grave (g),2007-04-01,0,0,1,0,1,0,1
PADILLA,desnutricion aguda,desnutricion grave (g),2007-04-01,0,0,2,5,2,5,7
PASORAPA,desnutricion aguda,desnutricion grave (g),2007-04-01,1,0,1,0,2,0,2
POCOATA,desnutricion aguda,desnutricion grave (g),2007-04-01,1,2,0,2,1,4,5
POJO (CBBA),desnutricion aguda,desnutricion grave (g),2007-04-01,0,1,0,0,0,1,1
POOPO,desnutricion aguda,desnutricion grave (g),2007-04-01,0,0,1,0,1,0,1
PORCO,desnutricion aguda,desnutricion grave (g),2007-04-01,0,0,1,0,1,0,1
POROMA,desnutricion aguda,desnutricion grave (g),2007-04-01,6,11,12,4,18,15,33
PORONGO,desnutricion aguda,desnutricion grave (g),2007-04-01,1,0,0,0,1,0,1
PORVENIR,desnutricion aguda,desnutricion grave (g),2007-04-01,1,1,0,0,1,1,2
POTOSI,desnutricion aguda,desnutricion grave (g),2007-04-01,8,8,3,4,11,12,23
PRESTO,desnutricion aguda,desnutricion grave (g),2007-04-01,4,1,3,3,7,4,11
PUERTO GONZALO MORENO,desnutricion aguda,desnutricion grave (g),2007-04-01,1,1,0,0,1,1,2
PUERTO QUIJARRO,desnutricion aguda,desnutricion grave (g),2007-04-01,2,0,0,1,2,1,3
PUERTO VILLARROEL,desnutricion aguda,desnutricion grave (g),2007-04-01,17,11,5,0,22,11,33
PUNA,desnutricion aguda,desnutricion grave (g),2007-04-01,2,2,0,0,2,2,4
PUNATA,desnutricion aguda,desnutricion grave (g),2007-04-01,0,0,1,0,1,0,1
QUILLACOLLO,desnutricion aguda,desnutricion grave (g),2007-04-01,2,2,1,2,3,4,7
RAVELO,desnutricion aguda,desnutricion grave (g),2007-04-01,4,7,1,5,5,12,17
RIBERALTA,desnutricion aguda,desnutricion grave (g),2007-04-01,14,16,0,6,14,22,36
RURRENABAQUE,desnutricion aguda,desnutricion grave (g),2007-04-01,1,0,0,0,1,0,1
SACABA,desnutricion aguda,desnutricion grave (g),2007-04-01,6,1,0,3,6,4,10
SACACA,desnutricion aguda,desnutricion grave (g),2007-04-01,5,2,2,3,7,5,12
SAN BENITO,desnutricion aguda,desnutricion grave (g),2007-04-01,0,1,0,2,0,3,3
SAN BORJA,desnutricion aguda,desnutricion grave (g),2007-04-01,4,1,2,0,6,1,7
SAN CARLOS,desnutricion aguda,desnutricion grave (g),2007-04-01,5,1,0,0,5,1,6
SAN IGNACIO,desnutricion aguda,desnutricion grave (g),2007-04-01,0,1,1,0,1,1,2
SAN IGNACIO DE VELASCO,desnutricion aguda,desnutricion grave (g),2007-04-01,2,8,1,5,3,13,16
SAN JOSE DE CHIQUITOS,desnutricion aguda,desnutricion grave (g),2007-04-01,0,2,0,0,0,2,2
SAN JULIAN,desnutricion aguda,desnutricion grave (g),2007-04-01,0,1,0,0,0,1,1
SAN LORENZO(TJA),desnutricion aguda,desnutricion grave (g),2007-04-01,0,1,0,0,0,1,1
SAN LUCAS,desnutricion aguda,desnutricion grave (g),2007-04-01,13,6,3,3,16,9,25
SAN PABLO DE LIPEZ,desnutricion aguda,desnutricion grave (g),2007-04-01,0,1,0,0,0,1,1
SAN PEDRO,desnutricion aguda,desnutricion grave (g),2007-04-01,1,1,0,0,1,1,2
SAN PEDRO(PND),desnutricion aguda,desnutricion grave (g),2007-04-01,1,0,0,0,1,0,1
SAN RAMON,desnutricion aguda,desnutricion grave (g),2007-04-01,0,1,1,0,1,1,2
SANTA ANA,desnutricion aguda,desnutricion grave (g),2007-04-01,0,1,0,0,0,1,1
SANTA CRUZ DE LA SIERRA,desnutricion aguda,desnutricion grave (g),2007-04-01,20,15,12,6,32,21,53
SANTA ROSA DEL SARA,desnutricion aguda,desnutricion grave (g),2007-04-01,0,0,0,1,0,1,1
SIPE SIPE,desnutricion aguda,desnutricion grave (g),2007-04-01,4,4,1,0,5,4,9
SOPACHUY,desnutricion aguda,desnutricion grave (g),2007-04-01,4,5,1,2,5,7,12
SORACACHI,desnutricion aguda,desnutricion grave (g),2007-04-01,1,1,0,0,1,1,2
SUCRE,desnutricion aguda,desnutricion grave (g),2007-04-01,10,2,2,6,12,8,20
TACOBAMBA,desnutricion aguda,desnutricion grave (g),2007-04-01,3,6,1,4,4,10,14
TACOPAYA,desnutricion aguda,desnutricion grave (g),2007-04-01,0,3,0,1,0,4,4
TAPACARI,desnutricion aguda,desnutricion grave (g),2007-04-01,14,3,1,1,15,4,19
TARABUCO,desnutricion aguda,desnutricion grave (g),2007-04-01,17,6,4,2,21,8,29
TARIJA,desnutricion aguda,desnutricion grave (g),2007-04-01,3,0,2,3,5,3,8
TARVITA,desnutricion aguda,desnutricion grave (g),2007-04-01,2,4,2,2,4,6,10
TINGUIPAYA,desnutricion aguda,desnutricion grave (g),2007-04-01,7,6,1,2,8,8,16
TIRAQUE (CBBA),desnutricion aguda,desnutricion grave (g),2007-04-01,3,3,1,0,4,3,7
TOMAVE,desnutricion aguda,desnutricion grave (g),2007-04-01,1,2,0,0,1,2,3
TOMINA,desnutricion aguda,desnutricion grave (g),2007-04-01,5,2,0,1,5,3,8
TORO TORO,desnutricion aguda,desnutricion grave (g),2007-04-01,1,0,1,2,2,2,4
TOTORA(ORR),desnutricion aguda,desnutricion grave (g),2007-04-01,0,1,0,0,0,1,1
TRINIDAD,desnutricion aguda,desnutricion grave (g),2007-04-01,2,0,0,0,2,0,2
TUPIZA,desnutricion aguda,desnutricion grave (g),2007-04-01,1,0,2,0,3,0,3
UNCIA,desnutricion aguda,desnutricion grave (g),2007-04-01,2,1,0,1,2,2,4
URUBICHA,desnutricion aguda,desnutricion grave (g),2007-04-01,0,1,2,1,2,2,4
UYUNI,desnutricion aguda,desnutricion grave (g),2007-04-01,0,1,0,0,0,1,1
VACAS,desnutricion aguda,desnutricion grave (g),2007-04-01,2,0,0,0,2,0,2
VALLEGRANDE,desnutricion aguda,desnutricion grave (g),2007-04-01,1,2,0,0,1,2,3
VILA VILA,desnutricion aguda,desnutricion grave (g),2007-04-01,1,1,1,0,2,1,3
VILLA MONTES,desnutricion aguda,desnutricion grave (g),2007-04-01,1,1,1,1,2,2,4
VILLA NUEVA (LOMA ALTA),desnutricion aguda,desnutricion grave (g),2007-04-01,0,2,0,1,0,3,3
VILLA SERRANO,desnutricion aguda,desnutricion grave (g),2007-04-01,0,0,4,1,4,1,5
VILLA TUNARI,desnutricion aguda,desnutricion grave (g),2007-04-01,2,6,2,2,4,8,12
VILLAZON,desnutricion aguda,desnutricion grave (g),2007-04-01,1,1,0,0,1,1,2
VITICHI,desnutricion aguda,desnutricion grave (g),2007-04-01,4,2,1,1,5,3,8
WARNES,desnutricion aguda,desnutricion grave (g),2007-04-01,0,1,0,1,0,2,2
YACUIBA,desnutricion aguda,desnutricion grave (g),2007-04-01,2,4,0,0,2,4,6
YAMPARAEZ,desnutricion aguda,desnutricion grave (g),2007-04-01,0,0,2,3,2,3,5
YAPACANI,desnutricion aguda,desnutricion grave (g),2007-04-01,1,2,0,0,1,2,3
YOTALA,desnutricion aguda,desnutricion grave (g),2007-04-01,0,1,1,0,1,1,2
YUNCHARA,desnutricion aguda,desnutricion grave (g),2007-04-01,0,0,2,0,2,0,2
ZUDAÑEZ,desnutricion aguda,desnutricion grave (g),2007-04-01,2,1,1,2,3,3,6
ACACIO,desnutricion aguda,desnutricion grave (g),2007-05-01,1,1,0,1,1,2,3
AIQUILE,desnutricion aguda,desnutricion grave (g),2007-05-01,3,4,2,2,5,6,11
ALCALA,desnutricion aguda,desnutricion grave (g),2007-05-01,0,1,0,1,0,2,2
ANDAMARCA,desnutricion aguda,desnutricion grave (g),2007-05-01,0,1,0,0,0,1,1
ANTEQUERA,desnutricion aguda,desnutricion grave (g),2007-05-01,2,1,0,0,2,1,3
ANZALDO,desnutricion aguda,desnutricion grave (g),2007-05-01,2,0,0,0,2,0,2
ARAMPAMPA,desnutricion aguda,desnutricion grave (g),2007-05-01,5,2,2,3,7,5,12
ARQUE,desnutricion aguda,desnutricion grave (g),2007-05-01,0,0,0,2,0,2,2
AYOPAYA (V. DE INDEPENDENCIA),desnutricion aguda,desnutricion grave (g),2007-05-01,2,1,1,1,3,2,5
AZURDUY,desnutricion aguda,desnutricion grave (g),2007-05-01,2,4,2,3,4,7,11
BELLA FLOR,desnutricion aguda,desnutricion grave (g),2007-05-01,0,1,0,0,0,1,1
BETANZOS,desnutricion aguda,desnutricion grave (g),2007-05-01,5,5,0,3,5,8,13
BOLIVAR,desnutricion aguda,desnutricion grave (g),2007-05-01,3,1,3,3,6,4,10
CABEZAS,desnutricion aguda,desnutricion grave (g),2007-05-01,0,1,0,0,0,1,1
"CAIZA ""D""",desnutricion aguda,desnutricion grave (g),2007-05-01,1,1,0,0,1,1,2
CAMARGO,desnutricion aguda,desnutricion grave (g),2007-05-01,1,1,2,2,3,3,6
CAMATAQUI (C. VILLA ABECIA),desnutricion aguda,desnutricion grave (g),2007-05-01,0,0,0,1,0,1,1
CAMIRI,desnutricion aguda,desnutricion grave (g),2007-05-01,2,1,1,1,3,2,5
CAPINOTA,desnutricion aguda,desnutricion grave (g),2007-05-01,2,1,0,0,2,1,3
CARAPARI,desnutricion aguda,desnutricion grave (g),2007-05-01,1,0,0,0,1,0,1
CARIPUYO,desnutricion aguda,desnutricion grave (g),2007-05-01,2,1,0,1,2,2,4
CHALLAPATA,desnutricion aguda,desnutricion grave (g),2007-05-01,0,0,1,0,1,0,1
CHAQUI,desnutricion aguda,desnutricion grave (g),2007-05-01,1,0,0,0,1,0,1
CHARAGUA,desnutricion aguda,desnutricion grave (g),2007-05-01,1,0,1,0,2,0,2
CHAYANTA,desnutricion aguda,desnutricion grave (g),2007-05-01,0,1,0,2,0,3,3
CHIMORE,desnutricion aguda,desnutricion grave (g),2007-05-01,1,4,1,5,2,9,11
CHOQUE COTA,desnutricion aguda,desnutricion grave (g),2007-05-01,1,0,0,0,1,0,1
COCHABAMBA,desnutricion aguda,desnutricion grave (g),2007-05-01,9,6,5,3,14,9,23
COLCAPIRHUA,desnutricion aguda,desnutricion grave (g),2007-05-01,1,0,0,0,1,0,1
"COLCHA ""K""",desnutricion aguda,desnutricion grave (g),2007-05-01,1,0,1,0,2,0,2
COLOMI,desnutricion aguda,desnutricion grave (g),2007-05-01,2,2,1,0,3,2,5
COLQUECHACA,desnutricion aguda,desnutricion grave (g),2007-05-01,3,4,2,1,5,5,10
COMARAPA,desnutricion aguda,desnutricion grave (g),2007-05-01,0,2,0,0,0,2,2
COTAGAITA,desnutricion aguda,desnutricion grave (g),2007-05-01,3,6,2,1,5,7,12
COTOCA,desnutricion aguda,desnutricion grave (g),2007-05-01,0,1,0,0,0,1,1
CUEVO,desnutricion aguda,desnutricion grave (g),2007-05-01,0,1,0,0,0,1,1
CULPINA,desnutricion aguda,desnutricion grave (g),2007-05-01,4,3,0,1,4,4,8
EL PUENTE(STC),desnutricion aguda,desnutricion grave (g),2007-05-01,0,1,0,0,0,1,1
EL TORNO,desnutricion aguda,desnutricion grave (g),2007-05-01,2,0,0,0,2,0,2
EL VILLAR,desnutricion aguda,desnutricion grave (g),2007-05-01,1,1,0,0,1,1,2
ENTRE RIOS,desnutricion aguda,desnutricion grave (g),2007-05-01,0,2,1,0,1,2,3
ENTRE RIOS,desnutricion aguda,desnutricion grave (g),2007-05-01,0,1,0,3,0,4,4
GUAYARAMERIN,desnutricion aguda,desnutricion grave (g),2007-05-01,1,1,1,0,2,1,3
GUTIERREZ,desnutricion aguda,desnutricion grave (g),2007-05-01,1,3,0,0,1,3,4
ICHOCA,desnutricion aguda,desnutricion grave (g),2007-05-01,0,1,0,0,0,1,1
ICLA,desnutricion aguda,desnutricion grave (g),2007-05-01,3,2,0,0,3,2,5
INCAHUASI,desnutricion aguda,desnutricion grave (g),2007-05-01,4,2,0,2,4,4,8
INQUISIVI,desnutricion aguda,desnutricion grave (g),2007-05-01,0,1,0,0,0,1,1
LA GUARDIA,desnutricion aguda,desnutricion grave (g),2007-05-01,1,2,0,1,1,3,4
LA RIVERA,desnutricion aguda,desnutricion grave (g),2007-05-01,0,1,0,0,0,1,1
LLALLAGUA,desnutricion aguda,desnutricion grave (g),2007-05-01,3,3,4,2,7,5,12
MAGDALENA,desnutricion aguda,desnutricion grave (g),2007-05-01,1,0,0,0,1,0,1
MAIRANA,desnutricion aguda,desnutricion grave (g),2007-05-01,1,0,0,0,1,0,1
MINEROS,desnutricion aguda,desnutricion grave (g),2007-05-01,1,0,0,0,1,0,1
MIZQUE,desnutricion aguda,desnutricion grave (g),2007-05-01,0,2,0,1,0,3,3
MONTEAGUDO,desnutricion aguda,desnutricion grave (g),2007-05-01,2,1,2,2,4,3,7
MONTERO,desnutricion aguda,desnutricion grave (g),2007-05-01,4,7,0,2,4,9,13
MOROCHATA,desnutricion aguda,desnutricion grave (g),2007-05-01,1,2,0,1,1,3,4
OCURI,desnutricion aguda,desnutricion grave (g),2007-05-01,2,2,0,3,2,5,7
OKINAWA,desnutricion aguda,desnutricion grave (g),2007-05-01,1,0,0,0,1,0,1
ORURO,desnutricion aguda,desnutricion grave (g),2007-05-01,8,4,10,1,18,5,23
PADILLA,desnutricion aguda,desnutricion grave (g),2007-05-01,1,1,2,1,3,2,5
PAILON,desnutricion aguda,desnutricion grave (g),2007-05-01,1,0,0,0,1,0,1
PAZÑA,desnutricion aguda,desnutricion grave (g),2007-05-01,0,1,0,0,0,1,1
POCOATA,desnutricion aguda,desnutricion grave (g),2007-05-01,1,2,0,4,1,6,7
POCONA,desnutricion aguda,desnutricion grave (g),2007-05-01,0,3,2,0,2,3,5
PORCO,desnutricion aguda,desnutricion grave (g),2007-05-01,2,0,1,1,3,1,4
POROMA,desnutricion aguda,desnutricion grave (g),2007-05-01,3,6,1,4,4,10,14
POTOSI,desnutricion aguda,desnutricion grave (g),2007-05-01,11,10,5,3,16,13,29
PRESTO,desnutricion aguda,desnutricion grave (g),2007-05-01,2,1,0,1,2,2,4
PUERTO QUIJARRO,desnutricion aguda,desnutricion grave (g),2007-05-01,0,1,0,0,0,1,1
PUERTO RICO,desnutricion aguda,desnutricion grave (g),2007-05-01,0,1,0,0,0,1,1
PUERTO SUAREZ,desnutricion aguda,desnutricion grave (g),2007-05-01,1,1,0,0,1,1,2
PUERTO VILLARROEL,desnutricion aguda,desnutricion grave (g),2007-05-01,21,9,7,8,28,17,45
PUNA,desnutricion aguda,desnutricion grave (g),2007-05-01,8,8,1,3,9,11,20
QUILLACOLLO,desnutricion aguda,desnutricion grave (g),2007-05-01,0,0,0,2,0,2,2
RAVELO,desnutricion aguda,desnutricion grave (g),2007-05-01,7,7,1,6,8,13,21
RIBERALTA,desnutricion aguda,desnutricion grave (g),2007-05-01,9,22,4,2,13,24,37
RURRENABAQUE,desnutricion aguda,desnutricion grave (g),2007-05-01,2,0,0,0,2,0,2
SACABA,desnutricion aguda,desnutricion grave (g),2007-05-01,3,3,1,1,4,4,8
SACABAMBA,desnutricion aguda,desnutricion grave (g),2007-05-01,0,1,0,0,0,1,1
SACACA,desnutricion aguda,desnutricion grave (g),2007-05-01,5,2,0,0,5,2,7
SAMAIPATA,desnutricion aguda,desnutricion grave (g),2007-05-01,0,0,0,1,0,1,1
SAN BENITO,desnutricion aguda,desnutricion grave (g),2007-05-01,0,0,1,0,1,0,1
SAN BORJA,desnutricion aguda,desnutricion grave (g),2007-05-01,1,1,4,2,5,3,8
SAN CARLOS,desnutricion aguda,desnutricion grave (g),2007-05-01,3,2,2,0,5,2,7
SAN IGNACIO,desnutricion aguda,desnutricion grave (g),2007-05-01,2,8,1,0,3,8,11
SAN IGNACIO DE VELASCO,desnutricion aguda,desnutricion grave (g),2007-05-01,4,4,1,4,5,8,13
SAN JOSE DE CHIQUITOS,desnutricion aguda,desnutricion grave (g),2007-05-01,0,1,1,1,1,2,3
SAN JULIAN,desnutricion aguda,desnutricion grave (g),2007-05-01,0,0,1,1,1,1,2
SAN LORENZO(TJA),desnutricion aguda,desnutricion grave (g),2007-05-01,0,3,0,0,0,3,3
SAN LUCAS,desnutricion aguda,desnutricion grave (g),2007-05-01,8,5,4,3,12,8,20
SAN MATIAS,desnutricion aguda,desnutricion grave (g),2007-05-01,1,0,0,0,1,0,1
SAN PABLO DE LIPEZ,desnutricion aguda,desnutricion grave (g),2007-05-01,0,2,0,0,0,2,2
SAN PEDRO,desnutricion aguda,desnutricion grave (g),2007-05-01,0,1,0,0,0,1,1
SAN PEDRO DE BUENA VISTA,desnutricion aguda,desnutricion grave (g),2007-05-01,0,1,0,1,0,2,2
SAN PEDRO(PND),desnutricion aguda,desnutricion grave (g),2007-05-01,1,0,0,1,1,1,2
SAN RAMON,desnutricion aguda,desnutricion grave (g),2007-05-01,1,2,0,0,1,2,3
SANTA ANA,desnutricion aguda,desnutricion grave (g),2007-05-01,1,1,1,1,2,2,4
SANTA CRUZ DE LA SIERRA,desnutricion aguda,desnutricion grave (g),2007-05-01,7,6,3,2,10,8,18
SANTA ROSA,desnutricion aguda,desnutricion grave (g),2007-05-01,1,1,0,2,1,3,4
SANTA ROSA DEL SARA,desnutricion aguda,desnutricion grave (g),2007-05-01,0,2,1,1,1,3,4
SANTIVAÑES,desnutricion aguda,desnutricion grave (g),2007-05-01,0,0,0,1,0,1,1
SANTUARIO DE QUILLACAS,desnutricion aguda,desnutricion grave (g),2007-05-01,1,0,1,1,2,1,3
SENA,desnutricion aguda,desnutricion grave (g),2007-05-01,1,0,0,0,1,0,1
SIPE SIPE,desnutricion aguda,desnutricion grave (g),2007-05-01,2,5,2,1,4,6,10
SOPACHUY,desnutricion aguda,desnutricion grave (g),2007-05-01,2,5,0,0,2,5,7
SORACACHI,desnutricion aguda,desnutricion grave (g),2007-05-01,0,2,0,0,0,2,2
SUCRE,desnutricion aguda,desnutricion grave (g),2007-05-01,6,7,3,5,9,12,21
TACOBAMBA,desnutricion aguda,desnutricion grave (g),2007-05-01,3,4,0,0,3,4,7
TACOPAYA,desnutricion aguda,desnutricion grave (g),2007-05-01,1,0,0,1,1,1,2
TAPACARI,desnutricion aguda,desnutricion grave (g),2007-05-01,3,4,0,1,3,5,8
TARABUCO,desnutricion aguda,desnutricion grave (g),2007-05-01,12,9,3,4,15,13,28
TARATA,desnutricion aguda,desnutricion grave (g),2007-05-01,1,0,0,0,1,0,1
TARIJA,desnutricion aguda,desnutricion grave (g),2007-05-01,4,3,1,2,5,5,10
TARVITA,desnutricion aguda,desnutricion grave (g),2007-05-01,5,2,0,2,5,4,9
TINGUIPAYA,desnutricion aguda,desnutricion grave (g),2007-05-01,4,2,3,2,7,4,11
TIRAQUE (CBBA),desnutricion aguda,desnutricion grave (g),2007-05-01,3,0,0,3,3,3,6
TOMAVE,desnutricion aguda,desnutricion grave (g),2007-05-01,0,3,1,1,1,4,5
TOMINA,desnutricion aguda,desnutricion grave (g),2007-05-01,4,1,1,1,5,2,7
TORO TORO,desnutricion aguda,desnutricion grave (g),2007-05-01,2,2,1,1,3,3,6
TOTORA(CBBA),desnutricion aguda,desnutricion grave (g),2007-05-01,2,2,0,1,2,3,5
TOTORA(ORR),desnutricion aguda,desnutricion grave (g),2007-05-01,0,0,0,1,0,1,1
TRINIDAD,desnutricion aguda,desnutricion grave (g),2007-05-01,4,1,1,1,5,2,7
TUPIZA,desnutricion aguda,desnutricion grave (g),2007-05-01,3,2,1,0,4,2,6
UNCIA,desnutricion aguda,desnutricion grave (g),2007-05-01,2,1,0,0,2,1,3
URIONDO (A. CONCEPCION),desnutricion aguda,desnutricion grave (g),2007-05-01,1,0,0,0,1,0,1
URUBICHA,desnutricion aguda,desnutricion grave (g),2007-05-01,3,2,2,0,5,2,7
VACAS,desnutricion aguda,desnutricion grave (g),2007-05-01,0,0,0,1,0,1,1
VALLEGRANDE,desnutricion aguda,desnutricion grave (g),2007-05-01,0,0,0,1,0,1,1
VILA VILA,desnutricion aguda,desnutricion grave (g),2007-05-01,0,2,0,0,0,2,2
VILLA MONTES,desnutricion aguda,desnutricion grave (g),2007-05-01,2,0,0,0,2,0,2
VILLA NUEVA (LOMA ALTA),desnutricion aguda,desnutricion grave (g),2007-05-01,0,2,1,0,1,2,3
VILLA RIVERO,desnutricion aguda,desnutricion grave (g),2007-05-01,0,1,0,0,0,1,1
VILLA SERRANO,desnutricion aguda,desnutricion grave (g),2007-05-01,1,1,1,0,2,1,3
VILLA TUNARI,desnutricion aguda,desnutricion grave (g),2007-05-01,5,4,0,0,5,4,9
VITICHI,desnutricion aguda,desnutricion grave (g),2007-05-01,3,2,0,3,3,5,8
WARNES,desnutricion aguda,desnutricion grave (g),2007-05-01,2,2,0,0,2,2,4
YACUIBA,desnutricion aguda,desnutricion grave (g),2007-05-01,1,1,0,0,1,1,2
YAMPARAEZ,desnutricion aguda,desnutricion grave (g),2007-05-01,1,0,2,1,3,1,4
YAPACANI,desnutricion aguda,desnutricion grave (g),2007-05-01,0,2,1,0,1,2,3
YOTALA,desnutricion aguda,desnutricion grave (g),2007-05-01,1,2,0,0,1,2,3
YUNCHARA,desnutricion aguda,desnutricion grave (g),2007-05-01,2,0,0,0,2,0,2
ZUDAÑEZ,desnutricion aguda,desnutricion grave (g),2007-05-01,1,0,4,0,5,0,5
ACACIO,desnutricion aguda,desnutricion grave (g),2007-06-01,3,3,0,1,3,4,7
AIQUILE,desnutricion aguda,desnutricion grave (g),2007-06-01,2,1,1,0,3,1,4
ALALAY,desnutricion aguda,desnutricion grave (g),2007-06-01,1,1,0,3,1,4,5
ANDAMARCA,desnutricion aguda,desnutricion grave (g),2007-06-01,1,0,0,0,1,0,1
ANZALDO,desnutricion aguda,desnutricion grave (g),2007-06-01,1,0,0,1,1,1,2
ARAMPAMPA,desnutricion aguda,desnutricion grave (g),2007-06-01,9,5,4,3,13,8,21
ARANI,desnutricion aguda,desnutricion grave (g),2007-06-01,0,1,0,0,0,1,1
ARBIETO,desnutricion aguda,desnutricion grave (g),2007-06-01,0,1,0,0,0,1,1
ARQUE,desnutricion aguda,desnutricion grave (g),2007-06-01,2,0,0,1,2,1,3
ASCENCION DE GUARAYOS,desnutricion aguda,desnutricion grave (g),2007-06-01,5,3,1,3,6,6,12
AYOPAYA (V. DE INDEPENDENCIA),desnutricion aguda,desnutricion grave (g),2007-06-01,2,1,2,0,4,1,5
AZURDUY,desnutricion aguda,desnutricion grave (g),2007-06-01,2,4,1,5,3,9,12
BELEN DE URMIRI,desnutricion aguda,desnutricion grave (g),2007-06-01,0,1,0,0,0,1,1
BETANZOS,desnutricion aguda,desnutricion grave (g),2007-06-01,10,12,0,2,10,14,24
BOLIVAR,desnutricion aguda,desnutricion grave (g),2007-06-01,1,2,0,0,1,2,3
"CAIZA ""D""",desnutricion aguda,desnutricion grave (g),2007-06-01,2,1,0,0,2,1,3
CAJUATA,desnutricion aguda,desnutricion grave (g),2007-06-01,1,0,0,0,1,0,1
CAMARGO,desnutricion aguda,desnutricion grave (g),2007-06-01,0,2,0,2,0,4,4
CAPINOTA,desnutricion aguda,desnutricion grave (g),2007-06-01,3,3,0,0,3,3,6
CARACOLLO,desnutricion aguda,desnutricion grave (g),2007-06-01,1,0,0,0,1,0,1
CARAPARI,desnutricion aguda,desnutricion grave (g),2007-06-01,1,0,1,0,2,0,2
CARIPUYO,desnutricion aguda,desnutricion grave (g),2007-06-01,3,5,0,0,3,5,8
CHALLAPATA,desnutricion aguda,desnutricion grave (g),2007-06-01,4,0,1,0,5,0,5
CHAQUI,desnutricion aguda,desnutricion grave (g),2007-06-01,2,0,1,1,3,1,4
CHAYANTA,desnutricion aguda,desnutricion grave (g),2007-06-01,3,0,1,2,4,2,6
CHIMORE,desnutricion aguda,desnutricion grave (g),2007-06-01,0,0,1,0,1,0,1
COCHABAMBA,desnutricion aguda,desnutricion grave (g),2007-06-01,9,14,1,4,10,18,28
COLCAPIRHUA,desnutricion aguda,desnutricion grave (g),2007-06-01,0,4,0,0,0,4,4
"COLCHA ""K""",desnutricion aguda,desnutricion grave (g),2007-06-01,0,0,1,0,1,0,1
COLOMI,desnutricion aguda,desnutricion grave (g),2007-06-01,3,1,1,0,4,1,5
COLPA BELGICA,desnutricion aguda,desnutricion grave (g),2007-06-01,1,0,0,0,1,0,1
COLQUECHACA,desnutricion aguda,desnutricion grave (g),2007-06-01,4,10,1,1,5,11,16
COLQUIRI,desnutricion aguda,desnutricion grave (g),2007-06-01,0,3,0,0,0,3,3
COMARAPA,desnutricion aguda,desnutricion grave (g),2007-06-01,0,1,1,0,1,1,2
CONCEPCION,desnutricion aguda,desnutricion grave (g),2007-06-01,0,1,0,0,0,1,1
COTAGAITA,desnutricion aguda,desnutricion grave (g),2007-06-01,4,6,1,4,5,10,15
COTOCA,desnutricion aguda,desnutricion grave (g),2007-06-01,0,1,0,1,0,2,2
CUATRO CAÑADAS,desnutricion aguda,desnutricion grave (g),2007-06-01,0,0,0,1,0,1,1
CULPINA,desnutricion aguda,desnutricion grave (g),2007-06-01,3,4,0,4,3,8,11
EL PUENTE(STC),desnutricion aguda,desnutricion grave (g),2007-06-01,0,1,0,1,0,2,2
EL TORNO,desnutricion aguda,desnutricion grave (g),2007-06-01,3,0,1,0,4,0,4
EL VILLAR,desnutricion aguda,desnutricion grave (g),2007-06-01,1,1,0,0,1,1,2
ENTRE RIOS,desnutricion aguda,desnutricion grave (g),2007-06-01,0,0,4,0,4,0,4
ENTRE RIOS,desnutricion aguda,desnutricion grave (g),2007-06-01,1,0,0,1,1,1,2
GENERAL SAAVEDRA,desnutricion aguda,desnutricion grave (g),2007-06-01,0,1,0,0,0,1,1
GUAYARAMERIN,desnutricion aguda,desnutricion grave (g),2007-06-01,2,2,0,1,2,3,5
GUTIERREZ,desnutricion aguda,desnutricion grave (g),2007-06-01,2,4,0,2,2,6,8
HUACARETA,desnutricion aguda,desnutricion grave (g),2007-06-01,0,0,0,1,0,1,1
HUACAYA (VILLA DE HUACAYA),desnutricion aguda,desnutricion grave (g),2007-06-01,1,0,0,0,1,0,1
HUANUNI,desnutricion aguda,desnutricion grave (g),2007-06-01,0,1,1,0,1,1,2
ICLA,desnutricion aguda,desnutricion grave (g),2007-06-01,5,8,1,1,6,9,15
INCAHUASI,desnutricion aguda,desnutricion grave (g),2007-06-01,3,3,0,1,3,4,7
INQUISIVI,desnutricion aguda,desnutricion grave (g),2007-06-01,1,1,1,0,2,1,3
LLALLAGUA,desnutricion aguda,desnutricion grave (g),2007-06-01,5,4,2,1,7,5,12
LLICA,desnutricion aguda,desnutricion grave (g),2007-06-01,1,1,0,0,1,1,2
MACHACAMARCA,desnutricion aguda,desnutricion grave (g),2007-06-01,1,0,0,0,1,0,1
MACHARETI,desnutricion aguda,desnutricion grave (g),2007-06-01,1,0,1,0,2,0,2
MIZQUE,desnutricion aguda,desnutricion grave (g),2007-06-01,0,3,0,0,0,3,3
MOJOCOYA,desnutricion aguda,desnutricion grave (g),2007-06-01,0,0,0,1,0,1,1
MONTEAGUDO,desnutricion aguda,desnutricion grave (g),2007-06-01,3,0,2,3,5,3,8
MONTERO,desnutricion aguda,desnutricion grave (g),2007-06-01,3,3,1,1,4,4,8
MOROCHATA,desnutricion aguda,desnutricion grave (g),2007-06-01,1,1,0,1,1,2,3
OCURI,desnutricion aguda,desnutricion grave (g),2007-06-01,7,5,1,2,8,7,15
OKINAWA,desnutricion aguda,desnutricion grave (g),2007-06-01,1,0,0,0,1,0,1
ORURO,desnutricion aguda,desnutricion grave (g),2007-06-01,1,2,1,0,2,2,4
PADCAYA,desnutricion aguda,desnutricion grave (g),2007-06-01,1,0,1,0,2,0,2
PADILLA,desnutricion aguda,desnutricion grave (g),2007-06-01,1,0,1,1,2,1,3
PAZÑA,desnutricion aguda,desnutricion grave (g),2007-06-01,1,1,0,0,1,1,2
POCOATA,desnutricion aguda,desnutricion grave (g),2007-06-01,2,2,1,4,3,6,9
POCONA,desnutricion aguda,desnutricion grave (g),2007-06-01,0,1,2,1,2,2,4
POJO (CBBA),desnutricion aguda,desnutricion grave (g),2007-06-01,2,2,0,0,2,2,4
PORCO,desnutricion aguda,desnutricion grave (g),2007-06-01,0,1,1,1,1,2,3
POROMA,desnutricion aguda,desnutricion grave (g),2007-06-01,7,9,1,3,8,12,20
PORTACHUELO,desnutricion aguda,desnutricion grave (g),2007-06-01,1,0,1,0,2,0,2
POTOSI,desnutricion aguda,desnutricion grave (g),2007-06-01,9,9,2,4,11,13,24
PRESTO,desnutricion aguda,desnutricion grave (g),2007-06-01,6,3,0,1,6,4,10
PUERTO GONZALO MORENO,desnutricion aguda,desnutricion grave (g),2007-06-01,0,2,0,0,0,2,2
PUERTO RICO,desnutricion aguda,desnutricion grave (g),2007-06-01,1,2,2,0,3,2,5
PUERTO SUAREZ,desnutricion aguda,desnutricion grave (g),2007-06-01,0,1,0,0,0,1,1
PUERTO VILLARROEL,desnutricion aguda,desnutricion grave (g),2007-06-01,4,8,3,2,7,10,17
PUNA,desnutricion aguda,desnutricion grave (g),2007-06-01,3,6,3,2,6,8,14
PUNATA,desnutricion aguda,desnutricion grave (g),2007-06-01,0,3,0,0,0,3,3
QUILLACOLLO,desnutricion aguda,desnutricion grave (g),2007-06-01,3,1,0,1,3,2,5
QUIME,desnutricion aguda,desnutricion grave (g),2007-06-01,2,3,0,0,2,3,5
RAVELO,desnutricion aguda,desnutricion grave (g),2007-06-01,11,6,2,2,13,8,21
RIBERALTA,desnutricion aguda,desnutricion grave (g),2007-06-01,13,28,5,2,18,30,48
ROBORE,desnutricion aguda,desnutricion grave (g),2007-06-01,0,0,0,1,0,1,1
RURRENABAQUE,desnutricion aguda,desnutricion grave (g),2007-06-01,1,0,1,0,2,0,2
SACABA,desnutricion aguda,desnutricion grave (g),2007-06-01,2,3,0,3,2,6,8
SACACA,desnutricion aguda,desnutricion grave (g),2007-06-01,7,5,3,6,10,11,21
SAN ANTONIO DE LOMERIO,desnutricion aguda,desnutricion grave (g),2007-06-01,0,0,1,1,1,1,2
SAN BORJA,desnutricion aguda,desnutricion grave (g),2007-06-01,3,3,0,2,3,5,8
SAN CARLOS,desnutricion aguda,desnutricion grave (g),2007-06-01,1,1,0,0,1,1,2
SAN IGNACIO,desnutricion aguda,desnutricion grave (g),2007-06-01,2,5,1,0,3,5,8
SAN IGNACIO DE VELASCO,desnutricion aguda,desnutricion grave (g),2007-06-01,4,5,1,9,5,14,19
SAN JOSE DE CHIQUITOS,desnutricion aguda,desnutricion grave (g),2007-06-01,0,0,0,2,0,2,2
SAN JULIAN,desnutricion aguda,desnutricion grave (g),2007-06-01,0,0,1,0,1,0,1
SAN LORENZO(PND),desnutricion aguda,desnutricion grave (g),2007-06-01,0,0,0,1,0,1,1
SAN LORENZO(TJA),desnutricion aguda,desnutricion grave (g),2007-06-01,1,2,0,0,1,2,3
SAN LUCAS,desnutricion aguda,desnutricion grave (g),2007-06-01,13,9,5,3,18,12,30
SAN PABLO DE LIPEZ,desnutricion aguda,desnutricion grave (g),2007-06-01,0,1,0,0,0,1,1
SAN PEDRO DE BUENA VISTA,desnutricion aguda,desnutricion grave (g),2007-06-01,6,5,1,1,7,6,13
SAN PEDRO(PND),desnutricion aguda,desnutricion grave (g),2007-06-01,1,0,0,0,1,0,1
SAN RAMON,desnutricion aguda,desnutricion grave (g),2007-06-01,1,1,0,0,1,1,2
SANTA ANA,desnutricion aguda,desnutricion grave (g),2007-06-01,4,1,1,3,5,4,9
SANTA CRUZ DE LA SIERRA,desnutricion aguda,desnutricion grave (g),2007-06-01,9,12,6,1,15,13,28
SANTA ROSA,desnutricion aguda,desnutricion grave (g),2007-06-01,0,1,2,0,2,1,3
SANTA ROSA DEL SARA,desnutricion aguda,desnutricion grave (g),2007-06-01,3,3,1,1,4,4,8
SANTIAGO DE HUARI,desnutricion aguda,desnutricion grave (g),2007-06-01,0,0,0,1,0,1,1
SICAYA,desnutricion aguda,desnutricion grave (g),2007-06-01,0,3,0,0,0,3,3
SIPE SIPE,desnutricion aguda,desnutricion grave (g),2007-06-01,5,1,2,1,7,2,9
SOPACHUY,desnutricion aguda,desnutricion grave (g),2007-06-01,1,3,0,1,1,4,5
SORACACHI,desnutricion aguda,desnutricion grave (g),2007-06-01,2,2,1,0,3,2,5
SUCRE,desnutricion aguda,desnutricion grave (g),2007-06-01,5,7,4,6,9,13,22
TACOBAMBA,desnutricion aguda,desnutricion grave (g),2007-06-01,3,3,2,2,5,5,10
TACOPAYA,desnutricion aguda,desnutricion grave (g),2007-06-01,0,2,1,1,1,3,4
TAPACARI,desnutricion aguda,desnutricion grave (g),2007-06-01,10,7,2,1,12,8,20
TARABUCO,desnutricion aguda,desnutricion grave (g),2007-06-01,11,13,0,2,11,15,26
TARATA,desnutricion aguda,desnutricion grave (g),2007-06-01,2,0,0,0,2,0,2
TARIJA,desnutricion aguda,desnutricion grave (g),2007-06-01,3,5,0,4,3,9,12
TARVITA,desnutricion aguda,desnutricion grave (g),2007-06-01,2,1,1,0,3,1,4
TINGUIPAYA,desnutricion aguda,desnutricion grave (g),2007-06-01,10,7,6,5,16,12,28
TIQUIPAYA,desnutricion aguda,desnutricion grave (g),2007-06-01,1,0,0,0,1,0,1
TIRAQUE (CBBA),desnutricion aguda,desnutricion grave (g),2007-06-01,3,3,0,2,3,5,8
TOCO,desnutricion aguda,desnutricion grave (g),2007-06-01,0,1,0,0,0,1,1
TOLATA,desnutricion aguda,desnutricion grave (g),2007-06-01,0,0,0,1,0,1,1
TOMAVE,desnutricion aguda,desnutricion grave (g),2007-06-01,1,3,1,0,2,3,5
TOMINA,desnutricion aguda,desnutricion grave (g),2007-06-01,5,3,2,5,7,8,15
TORO TORO,desnutricion aguda,desnutricion grave (g),2007-06-01,3,4,2,3,5,7,12
TOTORA(CBBA),desnutricion aguda,desnutricion grave (g),2007-06-01,1,0,1,0,2,0,2
TOTORA(ORR),desnutricion aguda,desnutricion grave (g),2007-06-01,0,1,0,0,0,1,1
TRINIDAD,desnutricion aguda,desnutricion grave (g),2007-06-01,8,2,0,3,8,5,13
TUPIZA,desnutricion aguda,desnutricion grave (g),2007-06-01,3,0,0,1,3,1,4
TURCO,desnutricion aguda,desnutricion grave (g),2007-06-01,0,0,1,1,1,1,2
UNCIA,desnutricion aguda,desnutricion grave (g),2007-06-01,2,3,1,0,3,3,6
URIONDO (A. CONCEPCION),desnutricion aguda,desnutricion grave (g),2007-06-01,1,0,0,0,1,0,1
URUBICHA,desnutricion aguda,desnutricion grave (g),2007-06-01,1,1,3,1,4,2,6
UYUNI,desnutricion aguda,desnutricion grave (g),2007-06-01,0,1,0,1,0,2,2
VALLEGRANDE,desnutricion aguda,desnutricion grave (g),2007-06-01,0,1,0,0,0,1,1
VIACHA,desnutricion aguda,desnutricion grave (g),2007-06-01,0,1,0,0,0,1,1
VILA VILA,desnutricion aguda,desnutricion grave (g),2007-06-01,0,0,0,2,0,2,2
VILLA MONTES,desnutricion aguda,desnutricion grave (g),2007-06-01,1,0,0,0,1,0,1
VILLA NUEVA (LOMA ALTA),desnutricion aguda,desnutricion grave (g),2007-06-01,0,2,0,1,0,3,3
VILLA SERRANO,desnutricion aguda,desnutricion grave (g),2007-06-01,0,0,1,1,1,1,2
VILLA TUNARI,desnutricion aguda,desnutricion grave (g),2007-06-01,2,5,1,3,3,8,11
VILLAZON,desnutricion aguda,desnutricion grave (g),2007-06-01,2,3,1,1,3,4,7
VITICHI,desnutricion aguda,desnutricion grave (g),2007-06-01,3,6,1,2,4,8,12
WARNES,desnutricion aguda,desnutricion grave (g),2007-06-01,0,1,0,0,0,1,1
YACUIBA,desnutricion aguda,desnutricion grave (g),2007-06-01,2,0,1,1,3,1,4
YAMPARAEZ,desnutricion aguda,desnutricion grave (g),2007-06-01,1,2,1,1,2,3,5
YAPACANI,desnutricion aguda,desnutricion grave (g),2007-06-01,1,0,1,0,2,0,2
YOTALA,desnutricion aguda,desnutricion grave (g),2007-06-01,0,1,1,0,1,1,2
ZUDAÑEZ,desnutricion aguda,desnutricion grave (g),2007-06-01,2,0,0,3,2,3,5
ACACIO,desnutricion aguda,desnutricion grave (g),2007-07-01,9,4,7,3,16,7,23
AIQUILE,desnutricion aguda,desnutricion grave (g),2007-07-01,1,1,0,0,1,1,2
ALCALA,desnutricion aguda,desnutricion grave (g),2007-07-01,1,2,0,2,1,4,5
ANZALDO,desnutricion aguda,desnutricion grave (g),2007-07-01,1,0,0,0,1,0,1
ARAMPAMPA,desnutricion aguda,desnutricion grave (g),2007-07-01,6,5,1,1,7,6,13
ARANI,desnutricion aguda,desnutricion grave (g),2007-07-01,1,1,0,1,1,2,3
ARBIETO,desnutricion aguda,desnutricion grave (g),2007-07-01,0,2,1,0,1,2,3
ARQUE,desnutricion aguda,desnutricion grave (g),2007-07-01,1,1,1,0,2,1,3
AYOPAYA (V. DE INDEPENDENCIA),desnutricion aguda,desnutricion grave (g),2007-07-01,0,1,1,1,1,2,3
AZURDUY,desnutricion aguda,desnutricion grave (g),2007-07-01,1,3,1,2,2,5,7
BELEN DE ANDAMARCA,desnutricion aguda,desnutricion grave (g),2007-07-01,1,0,0,0,1,0,1
BELLA FLOR,desnutricion aguda,desnutricion grave (g),2007-07-01,1,0,0,0,1,0,1
BETANZOS,desnutricion aguda,desnutricion grave (g),2007-07-01,3,15,2,2,5,17,22
BOLIVAR,desnutricion aguda,desnutricion grave (g),2007-07-01,4,0,1,3,5,3,8
CABEZAS,desnutricion aguda,desnutricion grave (g),2007-07-01,0,0,1,2,1,2,3
"CAIZA ""D""",desnutricion aguda,desnutricion grave (g),2007-07-01,1,0,1,0,2,0,2
CAMARGO,desnutricion aguda,desnutricion grave (g),2007-07-01,2,2,0,0,2,2,4
CAPINOTA,desnutricion aguda,desnutricion grave (g),2007-07-01,1,0,1,1,2,1,3
CARIPUYO,desnutricion aguda,desnutricion grave (g),2007-07-01,3,3,0,0,3,3,6
CHALLAPATA,desnutricion aguda,desnutricion grave (g),2007-07-01,2,0,1,0,3,0,3
CHARAGUA,desnutricion aguda,desnutricion grave (g),2007-07-01,1,0,0,0,1,0,1
CHAYANTA,desnutricion aguda,desnutricion grave (g),2007-07-01,4,2,1,1,5,3,8
CHIMORE,desnutricion aguda,desnutricion grave (g),2007-07-01,0,1,1,2,1,3,4
COBIJA,desnutricion aguda,desnutricion grave (g),2007-07-01,1,1,0,0,1,1,2
COCHABAMBA,desnutricion aguda,desnutricion grave (g),2007-07-01,5,4,8,2,13,6,19
COLCAPIRHUA,desnutricion aguda,desnutricion grave (g),2007-07-01,1,0,0,0,1,0,1
"COLCHA ""K""",desnutricion aguda,desnutricion grave (g),2007-07-01,0,1,0,0,0,1,1
COLOMI,desnutricion aguda,desnutricion grave (g),2007-07-01,0,1,0,1,0,2,2
COLQUECHACA,desnutricion aguda,desnutricion grave (g),2007-07-01,3,7,5,3,8,10,18
COLQUIRI,desnutricion aguda,desnutricion grave (g),2007-07-01,0,1,0,0,0,1,1
COMARAPA,desnutricion aguda,desnutricion grave (g),2007-07-01,2,0,0,1,2,1,3
COTAGAITA,desnutricion aguda,desnutricion grave (g),2007-07-01,2,2,1,0,3,2,5
CUEVO,desnutricion aguda,desnutricion grave (g),2007-07-01,1,0,0,0,1,0,1
CULPINA,desnutricion aguda,desnutricion grave (g),2007-07-01,6,0,0,0,6,0,6
EL VILLAR,desnutricion aguda,desnutricion grave (g),2007-07-01,1,1,0,1,1,2,3
ENTRE RIOS,desnutricion aguda,desnutricion grave (g),2007-07-01,1,1,0,0,1,1,2
GENERAL SAAVEDRA,desnutricion aguda,desnutricion grave (g),2007-07-01,0,0,0,1,0,1,1
GUAYARAMERIN,desnutricion aguda,desnutricion grave (g),2007-07-01,2,2,0,0,2,2,4
GUTIERREZ,desnutricion aguda,desnutricion grave (g),2007-07-01,4,3,2,1,6,4,10
HUACARETA,desnutricion aguda,desnutricion grave (g),2007-07-01,0,1,0,0,0,1,1
HUANUNI,desnutricion aguda,desnutricion grave (g),2007-07-01,0,2,0,1,0,3,3
ICLA,desnutricion aguda,desnutricion grave (g),2007-07-01,2,2,0,0,2,2,4
INCAHUASI,desnutricion aguda,desnutricion grave (g),2007-07-01,5,6,0,3,5,9,14
INQUISIVI,desnutricion aguda,desnutricion grave (g),2007-07-01,1,0,0,0,1,0,1
LA GUARDIA,desnutricion aguda,desnutricion grave (g),2007-07-01,0,3,0,1,0,4,4
LA RIVERA,desnutricion aguda,desnutricion grave (g),2007-07-01,0,1,0,0,0,1,1
LAGUNILLAS,desnutricion aguda,desnutricion grave (g),2007-07-01,0,1,0,0,0,1,1
LLALLAGUA,desnutricion aguda,desnutricion grave (g),2007-07-01,2,2,1,1,3,3,6
MACHARETI,desnutricion aguda,desnutricion grave (g),2007-07-01,0,1,1,0,1,1,2
MINEROS,desnutricion aguda,desnutricion grave (g),2007-07-01,0,1,0,0,0,1,1
MIZQUE,desnutricion aguda,desnutricion grave (g),2007-07-01,1,2,0,0,1,2,3
MONTEAGUDO,desnutricion aguda,desnutricion grave (g),2007-07-01,3,1,2,2,5,3,8
MONTERO,desnutricion aguda,desnutricion grave (g),2007-07-01,5,6,2,2,7,8,15
MOROCHATA,desnutricion aguda,desnutricion grave (g),2007-07-01,5,1,1,0,6,1,7
OCURI,desnutricion aguda,desnutricion grave (g),2007-07-01,3,4,0,0,3,4,7
ORURO,desnutricion aguda,desnutricion grave (g),2007-07-01,2,3,0,1,2,4,6
PADCAYA,desnutricion aguda,desnutricion grave (g),2007-07-01,1,0,0,0,1,0,1
PADILLA,desnutricion aguda,desnutricion grave (g),2007-07-01,0,0,1,1,1,1,2
PAILON,desnutricion aguda,desnutricion grave (g),2007-07-01,1,0,0,1,1,1,2
PALCA,desnutricion aguda,desnutricion grave (g),2007-07-01,1,0,0,0,1,0,1
POCOATA,desnutricion aguda,desnutricion grave (g),2007-07-01,3,3,1,1,4,4,8
POCONA,desnutricion aguda,desnutricion grave (g),2007-07-01,0,1,0,0,0,1,1
POJO (CBBA),desnutricion aguda,desnutricion grave (g),2007-07-01,1,0,1,0,2,0,2
PORCO,desnutricion aguda,desnutricion grave (g),2007-07-01,1,0,0,0,1,0,1
POROMA,desnutricion aguda,desnutricion grave (g),2007-07-01,4,11,3,3,7,14,21
PORTACHUELO,desnutricion aguda,desnutricion grave (g),2007-07-01,1,0,1,0,2,0,2
POTOSI,desnutricion aguda,desnutricion grave (g),2007-07-01,7,12,11,13,18,25,43
PRESTO,desnutricion aguda,desnutricion grave (g),2007-07-01,11,3,0,0,11,3,14
PUERTO GONZALO MORENO,desnutricion aguda,desnutricion grave (g),2007-07-01,3,0,2,0,5,0,5
PUERTO RICO,desnutricion aguda,desnutricion grave (g),2007-07-01,2,0,0,0,2,0,2
PUERTO SILES,desnutricion aguda,desnutricion grave (g),2007-07-01,1,0,0,0,1,0,1
PUERTO SUAREZ,desnutricion aguda,desnutricion grave (g),2007-07-01,1,1,0,0,1,1,2
PUERTO VILLARROEL,desnutricion aguda,desnutricion grave (g),2007-07-01,2,2,2,3,4,5,9
PUNA,desnutricion aguda,desnutricion grave (g),2007-07-01,5,10,4,0,9,10,19
PUNATA,desnutricion aguda,desnutricion grave (g),2007-07-01,1,0,0,0,1,0,1
QUILLACOLLO,desnutricion aguda,desnutricion grave (g),2007-07-01,1,1,1,0,2,1,3
QUIME,desnutricion aguda,desnutricion grave (g),2007-07-01,1,0,0,0,1,0,1
QUIRUSILLAS,desnutricion aguda,desnutricion grave (g),2007-07-01,1,0,0,0,1,0,1
RAVELO,desnutricion aguda,desnutricion grave (g),2007-07-01,5,7,1,3,6,10,16
RIBERALTA,desnutricion aguda,desnutricion grave (g),2007-07-01,13,22,1,5,14,27,41
ROBORE,desnutricion aguda,desnutricion grave (g),2007-07-01,0,3,0,0,0,3,3
SACABA,desnutricion aguda,desnutricion grave (g),2007-07-01,3,0,1,0,4,0,4
SACACA,desnutricion aguda,desnutricion grave (g),2007-07-01,6,6,1,4,7,10,17
SAIPINA,desnutricion aguda,desnutricion grave (g),2007-07-01,0,1,0,0,0,1,1
SALINAS DE GARCI MENDOZA,desnutricion aguda,desnutricion grave (g),2007-07-01,1,1,0,0,1,1,2
SAN ANTONIO DE LOMERIO,desnutricion aguda,desnutricion grave (g),2007-07-01,1,2,0,0,1,2,3
SAN BORJA,desnutricion aguda,desnutricion grave (g),2007-07-01,3,8,0,0,3,8,11
SAN CARLOS,desnutricion aguda,desnutricion grave (g),2007-07-01,1,0,1,1,2,1,3
SAN IGNACIO,desnutricion aguda,desnutricion grave (g),2007-07-01,2,1,0,0,2,1,3
SAN IGNACIO DE VELASCO,desnutricion aguda,desnutricion grave (g),2007-07-01,3,6,1,2,4,8,12
SAN JOAQUIN,desnutricion aguda,desnutricion grave (g),2007-07-01,0,1,0,0,0,1,1
SAN JOSE DE CHIQUITOS,desnutricion aguda,desnutricion grave (g),2007-07-01,1,0,0,1,1,1,2
SAN LORENZO(TJA),desnutricion aguda,desnutricion grave (g),2007-07-01,0,3,1,2,1,5,6
SAN LUCAS,desnutricion aguda,desnutricion grave (g),2007-07-01,5,4,6,5,11,9,20
SAN MIGUEL DE VELASCO,desnutricion aguda,desnutricion grave (g),2007-07-01,0,1,0,0,0,1,1
SAN PEDRO DE BUENA VISTA,desnutricion aguda,desnutricion grave (g),2007-07-01,4,3,1,0,5,3,8
SAN PEDRO(PND),desnutricion aguda,desnutricion grave (g),2007-07-01,0,0,1,0,1,0,1
SANTA ANA,desnutricion aguda,desnutricion grave (g),2007-07-01,2,0,0,0,2,0,2
SANTA CRUZ DE LA SIERRA,desnutricion aguda,desnutricion grave (g),2007-07-01,8,2,6,2,14,4,18
SANTA ROSA,desnutricion aguda,desnutricion grave (g),2007-07-01,0,0,1,1,1,1,2
SANTIAGO DE HUARI,desnutricion aguda,desnutricion grave (g),2007-07-01,0,0,1,0,1,0,1
SIPE SIPE,desnutricion aguda,desnutricion grave (g),2007-07-01,2,1,1,0,3,1,4
SOPACHUY,desnutricion aguda,desnutricion grave (g),2007-07-01,0,1,0,1,0,2,2
SORACACHI,desnutricion aguda,desnutricion grave (g),2007-07-01,1,2,1,0,2,2,4
SUCRE,desnutricion aguda,desnutricion grave (g),2007-07-01,4,5,3,3,7,8,15
TACOBAMBA,desnutricion aguda,desnutricion grave (g),2007-07-01,4,2,0,1,4,3,7
TACOPAYA,desnutricion aguda,desnutricion grave (g),2007-07-01,1,1,2,0,3,1,4
TAPACARI,desnutricion aguda,desnutricion grave (g),2007-07-01,10,4,0,2,10,6,16
TARABUCO,desnutricion aguda,desnutricion grave (g),2007-07-01,11,11,6,7,17,18,35
TARIJA,desnutricion aguda,desnutricion grave (g),2007-07-01,1,2,1,0,2,2,4
TARVITA,desnutricion aguda,desnutricion grave (g),2007-07-01,3,3,2,4,5,7,12
TINGUIPAYA,desnutricion aguda,desnutricion grave (g),2007-07-01,3,1,0,2,3,3,6
TIRAQUE (CBBA),desnutricion aguda,desnutricion grave (g),2007-07-01,2,6,1,0,3,6,9
TOLEDO,desnutricion aguda,desnutricion grave (g),2007-07-01,0,1,0,0,0,1,1
TOMAVE,desnutricion aguda,desnutricion grave (g),2007-07-01,0,1,0,0,0,1,1
TOMINA,desnutricion aguda,desnutricion grave (g),2007-07-01,2,1,2,0,4,1,5
TORO TORO,desnutricion aguda,desnutricion grave (g),2007-07-01,0,2,1,0,1,2,3
TOTORA(CBBA),desnutricion aguda,desnutricion grave (g),2007-07-01,0,0,0,1,0,1,1
TRINIDAD,desnutricion aguda,desnutricion grave (g),2007-07-01,5,7,3,0,8,7,15
TURCO,desnutricion aguda,desnutricion grave (g),2007-07-01,3,0,0,0,3,0,3
UNCIA,desnutricion aguda,desnutricion grave (g),2007-07-01,0,3,0,0,0,3,3
URIONDO (A. CONCEPCION),desnutricion aguda,desnutricion grave (g),2007-07-01,1,0,0,0,1,0,1
UYUNI,desnutricion aguda,desnutricion grave (g),2007-07-01,0,1,0,1,0,2,2
VACAS,desnutricion aguda,desnutricion grave (g),2007-07-01,1,1,1,0,2,1,3
VALLEGRANDE,desnutricion aguda,desnutricion grave (g),2007-07-01,0,1,0,1,0,2,2
VIACHA,desnutricion aguda,desnutricion grave (g),2007-07-01,0,1,0,0,0,1,1
VILA VILA,desnutricion aguda,desnutricion grave (g),2007-07-01,0,0,2,2,2,2,4
VILLA MONTES,desnutricion aguda,desnutricion grave (g),2007-07-01,0,0,0,1,0,1,1
VILLA NUEVA (LOMA ALTA),desnutricion aguda,desnutricion grave (g),2007-07-01,0,0,0,1,0,1,1
VILLA SERRANO,desnutricion aguda,desnutricion grave (g),2007-07-01,0,1,0,0,0,1,1
VILLA TUNARI,desnutricion aguda,desnutricion grave (g),2007-07-01,4,1,0,2,4,3,7
VILLAZON,desnutricion aguda,desnutricion grave (g),2007-07-01,0,0,0,1,0,1,1
VINTO,desnutricion aguda,desnutricion grave (g),2007-07-01,2,0,1,0,3,0,3
VITICHI,desnutricion aguda,desnutricion grave (g),2007-07-01,3,3,1,0,4,3,7
WARNES,desnutricion aguda,desnutricion grave (g),2007-07-01,0,1,1,0,1,1,2
YAMPARAEZ,desnutricion aguda,desnutricion grave (g),2007-07-01,1,0,3,0,4,0,4
YAPACANI,desnutricion aguda,desnutricion grave (g),2007-07-01,0,1,0,1,0,2,2
ZUDAÑEZ,desnutricion aguda,desnutricion grave (g),2007-07-01,3,0,1,3,4,3,7
ACACIO,desnutricion aguda,desnutricion grave (g),2007-08-01,1,1,1,2,2,3,5
AIQUILE,desnutricion aguda,desnutricion grave (g),2007-08-01,3,2,0,0,3,2,5
ALALAY,desnutricion aguda,desnutricion grave (g),2007-08-01,1,0,0,0,1,0,1
ALCALA,desnutricion aguda,desnutricion grave (g),2007-08-01,0,1,0,1,0,2,2
ANDAMARCA,desnutricion aguda,desnutricion grave (g),2007-08-01,1,0,0,0,1,0,1
ARAMPAMPA,desnutricion aguda,desnutricion grave (g),2007-08-01,5,4,5,2,10,6,16
ARBIETO,desnutricion aguda,desnutricion grave (g),2007-08-01,1,0,0,0,1,0,1
ARQUE,desnutricion aguda,desnutricion grave (g),2007-08-01,2,1,0,1,2,2,4
ASCENCION DE GUARAYOS,desnutricion aguda,desnutricion grave (g),2007-08-01,1,5,2,2,3,7,10
ATOCHA,desnutricion aguda,desnutricion grave (g),2007-08-01,1,0,1,1,2,1,3
AYOPAYA (V. DE INDEPENDENCIA),desnutricion aguda,desnutricion grave (g),2007-08-01,2,0,1,2,3,2,5
AZURDUY,desnutricion aguda,desnutricion grave (g),2007-08-01,2,4,1,4,3,8,11
BAURES,desnutricion aguda,desnutricion grave (g),2007-08-01,0,1,0,0,0,1,1
BELEN DE URMIRI,desnutricion aguda,desnutricion grave (g),2007-08-01,0,1,0,0,0,1,1
BETANZOS,desnutricion aguda,desnutricion grave (g),2007-08-01,4,10,0,4,4,14,18
BOLIVAR,desnutricion aguda,desnutricion grave (g),2007-08-01,0,1,1,1,1,2,3
BOLPEBRA,desnutricion aguda,desnutricion grave (g),2007-08-01,1,0,0,0,1,0,1
"CAIZA ""D""",desnutricion aguda,desnutricion grave (g),2007-08-01,0,2,0,0,0,2,2
CAJUATA,desnutricion aguda,desnutricion grave (g),2007-08-01,2,0,0,0,2,0,2
CAMARGO,desnutricion aguda,desnutricion grave (g),2007-08-01,1,1,0,3,1,4,5
CAMATAQUI (C. VILLA ABECIA),desnutricion aguda,desnutricion grave (g),2007-08-01,0,0,0,1,0,1,1
CAMIRI,desnutricion aguda,desnutricion grave (g),2007-08-01,0,0,1,1,1,1,2
CAPINOTA,desnutricion aguda,desnutricion grave (g),2007-08-01,1,1,0,1,1,2,3
CARIPUYO,desnutricion aguda,desnutricion grave (g),2007-08-01,2,1,0,3,2,4,6
CHALLAPATA,desnutricion aguda,desnutricion grave (g),2007-08-01,1,0,1,0,2,0,2
CHAQUI,desnutricion aguda,desnutricion grave (g),2007-08-01,1,1,0,0,1,1,2
CHAYANTA,desnutricion aguda,desnutricion grave (g),2007-08-01,2,1,0,3,2,4,6
CHIMORE,desnutricion aguda,desnutricion grave (g),2007-08-01,1,0,0,2,1,2,3
COBIJA,desnutricion aguda,desnutricion grave (g),2007-08-01,3,0,0,0,3,0,3
COCHABAMBA,desnutricion aguda,desnutricion grave (g),2007-08-01,10,13,3,2,13,15,28
COLCAPIRHUA,desnutricion aguda,desnutricion grave (g),2007-08-01,0,0,1,0,1,0,1
COLOMI,desnutricion aguda,desnutricion grave (g),2007-08-01,2,0,0,1,2,1,3
COLQUECHACA,desnutricion aguda,desnutricion grave (g),2007-08-01,5,7,0,0,5,7,12
COLQUIRI,desnutricion aguda,desnutricion grave (g),2007-08-01,1,0,0,0,1,0,1
COMARAPA,desnutricion aguda,desnutricion grave (g),2007-08-01,2,1,0,0,2,1,3
CONCEPCION,desnutricion aguda,desnutricion grave (g),2007-08-01,0,0,0,1,0,1,1
COTAGAITA,desnutricion aguda,desnutricion grave (g),2007-08-01,6,5,4,0,10,5,15
COTOCA,desnutricion aguda,desnutricion grave (g),2007-08-01,1,4,1,0,2,4,6
CUATRO CAÑADAS,desnutricion aguda,desnutricion grave (g),2007-08-01,0,1,0,0,0,1,1
CULPINA,desnutricion aguda,desnutricion grave (g),2007-08-01,8,8,2,2,10,10,20
EL PUENTE(STC),desnutricion aguda,desnutricion grave (g),2007-08-01,2,0,1,0,3,0,3
EL TORNO,desnutricion aguda,desnutricion grave (g),2007-08-01,2,0,1,0,3,0,3
EL VILLAR,desnutricion aguda,desnutricion grave (g),2007-08-01,0,1,0,0,0,1,1
ENTRE RIOS,desnutricion aguda,desnutricion grave (g),2007-08-01,1,1,0,0,1,1,2
ENTRE RIOS,desnutricion aguda,desnutricion grave (g),2007-08-01,1,2,0,1,1,3,4
EUCALIPTUS,desnutricion aguda,desnutricion grave (g),2007-08-01,0,0,1,0,1,0,1
GUAYARAMERIN,desnutricion aguda,desnutricion grave (g),2007-08-01,2,5,0,4,2,9,11
GUTIERREZ,desnutricion aguda,desnutricion grave (g),2007-08-01,1,3,0,2,1,5,6
HUACARETA,desnutricion aguda,desnutricion grave (g),2007-08-01,0,0,0,2,0,2,2
HUANUNI,desnutricion aguda,desnutricion grave (g),2007-08-01,1,0,0,0,1,0,1
ICLA,desnutricion aguda,desnutricion grave (g),2007-08-01,4,7,0,0,4,7,11
INCAHUASI,desnutricion aguda,desnutricion grave (g),2007-08-01,14,10,2,9,16,19,35
LA GUARDIA,desnutricion aguda,desnutricion grave (g),2007-08-01,2,1,0,0,2,1,3
LAGUNILLAS,desnutricion aguda,desnutricion grave (g),2007-08-01,0,1,1,1,1,2,3
LLALLAGUA,desnutricion aguda,desnutricion grave (g),2007-08-01,1,4,1,0,2,4,6
LLICA,desnutricion aguda,desnutricion grave (g),2007-08-01,0,0,0,1,0,1,1
MAGDALENA,desnutricion aguda,desnutricion grave (g),2007-08-01,0,0,1,0,1,0,1
MINEROS,desnutricion aguda,desnutricion grave (g),2007-08-01,0,3,0,0,0,3,3
MIZQUE,desnutricion aguda,desnutricion grave (g),2007-08-01,0,3,0,0,0,3,3
MOJOCOYA,desnutricion aguda,desnutricion grave (g),2007-08-01,2,1,0,0,2,1,3
MONTEAGUDO,desnutricion aguda,desnutricion grave (g),2007-08-01,0,0,3,1,3,1,4
MONTERO,desnutricion aguda,desnutricion grave (g),2007-08-01,6,6,0,4,6,10,16
MOROCHATA,desnutricion aguda,desnutricion grave (g),2007-08-01,2,3,0,1,2,4,6
OCURI,desnutricion aguda,desnutricion grave (g),2007-08-01,3,0,0,0,3,0,3
OKINAWA,desnutricion aguda,desnutricion grave (g),2007-08-01,0,0,2,0,2,0,2
ORURO,desnutricion aguda,desnutricion grave (g),2007-08-01,7,3,1,0,8,3,11
PADCAYA,desnutricion aguda,desnutricion grave (g),2007-08-01,1,0,0,0,1,0,1
PADILLA,desnutricion aguda,desnutricion grave (g),2007-08-01,1,0,1,0,2,0,2
PAILON,desnutricion aguda,desnutricion grave (g),2007-08-01,0,0,0,1,0,1,1
PALCA,desnutricion aguda,desnutricion grave (g),2007-08-01,0,0,0,1,0,1,1
PAZÑA,desnutricion aguda,desnutricion grave (g),2007-08-01,0,1,0,0,0,1,1
POCOATA,desnutricion aguda,desnutricion grave (g),2007-08-01,5,6,0,3,5,9,14
PORCO,desnutricion aguda,desnutricion grave (g),2007-08-01,1,1,0,0,1,1,2
POROMA,desnutricion aguda,desnutricion grave (g),2007-08-01,6,13,4,4,10,17,27
POTOSI,desnutricion aguda,desnutricion grave (g),2007-08-01,13,15,1,2,14,17,31
PRESTO,desnutricion aguda,desnutricion grave (g),2007-08-01,4,1,1,3,5,4,9
PUCARA,desnutricion aguda,desnutricion grave (g),2007-08-01,1,0,0,0,1,0,1
PUERTO GONZALO MORENO,desnutricion aguda,desnutricion grave (g),2007-08-01,2,2,0,0,2,2,4
PUERTO RICO,desnutricion aguda,desnutricion grave (g),2007-08-01,0,1,0,0,0,1,1
PUERTO VILLARROEL,desnutricion aguda,desnutricion grave (g),2007-08-01,15,7,4,1,19,8,27
PUNA,desnutricion aguda,desnutricion grave (g),2007-08-01,4,11,1,1,5,12,17
PUNATA,desnutricion aguda,desnutricion grave (g),2007-08-01,1,0,0,0,1,0,1
QUILLACOLLO,desnutricion aguda,desnutricion grave (g),2007-08-01,3,2,3,3,6,5,11
RAVELO,desnutricion aguda,desnutricion grave (g),2007-08-01,8,8,1,6,9,14,23
RIBERALTA,desnutricion aguda,desnutricion grave (g),2007-08-01,11,17,5,3,16,20,36
ROBORE,desnutricion aguda,desnutricion grave (g),2007-08-01,0,1,0,0,0,1,1
SACABA,desnutricion aguda,desnutricion grave (g),2007-08-01,3,3,0,0,3,3,6
SACACA,desnutricion aguda,desnutricion grave (g),2007-08-01,3,7,2,4,5,11,16
SALINAS DE GARCI MENDOZA,desnutricion aguda,desnutricion grave (g),2007-08-01,1,0,0,0,1,0,1
SAN ANDRES,desnutricion aguda,desnutricion grave (g),2007-08-01,0,1,0,0,0,1,1
SAN ANTONIO DE LOMERIO,desnutricion aguda,desnutricion grave (g),2007-08-01,2,0,0,0,2,0,2
SAN BENITO,desnutricion aguda,desnutricion grave (g),2007-08-01,0,1,2,0,2,1,3
SAN BORJA,desnutricion aguda,desnutricion grave (g),2007-08-01,7,4,7,14,14,18,32
SAN IGNACIO,desnutricion aguda,desnutricion grave (g),2007-08-01,2,5,0,3,2,8,10
SAN IGNACIO DE VELASCO,desnutricion aguda,desnutricion grave (g),2007-08-01,6,8,3,2,9,10,19
SAN JAVIER(STC),desnutricion aguda,desnutricion grave (g),2007-08-01,0,0,1,0,1,0,1
SAN JOSE DE CHIQUITOS,desnutricion aguda,desnutricion grave (g),2007-08-01,1,0,0,0,1,0,1
SAN JUAN DE YAPACANI,desnutricion aguda,desnutricion grave (g),2007-08-01,1,1,0,0,1,1,2
SAN JULIAN,desnutricion aguda,desnutricion grave (g),2007-08-01,1,0,0,0,1,0,1
SAN LORENZO(PND),desnutricion aguda,desnutricion grave (g),2007-08-01,1,0,1,1,2,1,3
SAN LUCAS,desnutricion aguda,desnutricion grave (g),2007-08-01,13,5,1,3,14,8,22
SAN PABLO DE LIPEZ,desnutricion aguda,desnutricion grave (g),2007-08-01,1,1,0,0,1,1,2
SAN PEDRO,desnutricion aguda,desnutricion grave (g),2007-08-01,0,1,0,0,0,1,1
SAN PEDRO DE BUENA VISTA,desnutricion aguda,desnutricion grave (g),2007-08-01,3,4,3,1,6,5,11
SAN PEDRO(PND),desnutricion aguda,desnutricion grave (g),2007-08-01,2,0,1,0,3,0,3
SAN RAMON,desnutricion aguda,desnutricion grave (g),2007-08-01,2,1,0,0,2,1,3
SANTA ANA,desnutricion aguda,desnutricion grave (g),2007-08-01,4,0,0,0,4,0,4
SANTA CRUZ DE LA SIERRA,desnutricion aguda,desnutricion grave (g),2007-08-01,3,5,1,7,4,12,16
SANTA ROSA,desnutricion aguda,desnutricion grave (g),2007-08-01,0,1,1,1,1,2,3
SANTA ROSA DEL SARA,desnutricion aguda,desnutricion grave (g),2007-08-01,0,0,2,0,2,0,2
SANTIAGO DE HUARI,desnutricion aguda,desnutricion grave (g),2007-08-01,1,0,0,0,1,0,1
SENA,desnutricion aguda,desnutricion grave (g),2007-08-01,2,0,0,0,2,0,2
SICAYA,desnutricion aguda,desnutricion grave (g),2007-08-01,1,1,0,1,1,2,3
SIPE SIPE,desnutricion aguda,desnutricion grave (g),2007-08-01,1,3,0,0,1,3,4
SOPACHUY,desnutricion aguda,desnutricion grave (g),2007-08-01,2,4,1,2,3,6,9
SORACACHI,desnutricion aguda,desnutricion grave (g),2007-08-01,0,1,0,1,0,2,2
SUCRE,desnutricion aguda,desnutricion grave (g),2007-08-01,6,2,4,3,10,5,15
TACOBAMBA,desnutricion aguda,desnutricion grave (g),2007-08-01,5,4,0,0,5,4,9
TACOPAYA,desnutricion aguda,desnutricion grave (g),2007-08-01,0,2,1,3,1,5,6
TAPACARI,desnutricion aguda,desnutricion grave (g),2007-08-01,8,1,1,0,9,1,10
TARABUCO,desnutricion aguda,desnutricion grave (g),2007-08-01,11,12,3,4,14,16,30
TARATA,desnutricion aguda,desnutricion grave (g),2007-08-01,2,0,0,0,2,0,2
TARIJA,desnutricion aguda,desnutricion grave (g),2007-08-01,2,0,0,1,2,1,3
TARVITA,desnutricion aguda,desnutricion grave (g),2007-08-01,1,4,2,2,3,6,9
TINGUIPAYA,desnutricion aguda,desnutricion grave (g),2007-08-01,5,1,2,1,7,2,9
TIQUIPAYA,desnutricion aguda,desnutricion grave (g),2007-08-01,2,0,0,0,2,0,2
TIRAQUE (CBBA),desnutricion aguda,desnutricion grave (g),2007-08-01,2,5,0,2,2,7,9
TOMAVE,desnutricion aguda,desnutricion grave (g),2007-08-01,1,1,0,0,1,1,2
TOMINA,desnutricion aguda,desnutricion grave (g),2007-08-01,4,3,2,2,6,5,11
TORO TORO,desnutricion aguda,desnutricion grave (g),2007-08-01,3,4,5,0,8,4,12
TOTORA(CBBA),desnutricion aguda,desnutricion grave (g),2007-08-01,1,2,1,0,2,2,4
TOTORA(ORR),desnutricion aguda,desnutricion grave (g),2007-08-01,1,0,0,0,1,0,1
TRINIDAD,desnutricion aguda,desnutricion grave (g),2007-08-01,1,9,0,3,1,12,13
TUPIZA,desnutricion aguda,desnutricion grave (g),2007-08-01,1,2,2,0,3,2,5
UNCIA,desnutricion aguda,desnutricion grave (g),2007-08-01,3,2,0,1,3,3,6
URIONDO (A. CONCEPCION),desnutricion aguda,desnutricion grave (g),2007-08-01,0,0,0,1,0,1,1
URUBICHA,desnutricion aguda,desnutricion grave (g),2007-08-01,2,1,1,0,3,1,4
UYUNI,desnutricion aguda,desnutricion grave (g),2007-08-01,2,1,0,1,2,2,4
VACAS,desnutricion aguda,desnutricion grave (g),2007-08-01,2,2,1,0,3,2,5
VALLEGRANDE,desnutricion aguda,desnutricion grave (g),2007-08-01,0,2,0,0,0,2,2
VILLA MONTES,desnutricion aguda,desnutricion grave (g),2007-08-01,0,1,0,0,0,1,1
VILLA NUEVA (LOMA ALTA),desnutricion aguda,desnutricion grave (g),2007-08-01,0,1,0,2,0,3,3
VILLA SERRANO,desnutricion aguda,desnutricion grave (g),2007-08-01,0,3,0,0,0,3,3
VILLA TUNARI,desnutricion aguda,desnutricion grave (g),2007-08-01,6,3,0,1,6,4,10
VILLAZON,desnutricion aguda,desnutricion grave (g),2007-08-01,1,1,0,0,1,1,2
VITICHI,desnutricion aguda,desnutricion grave (g),2007-08-01,1,1,0,0,1,1,2
WARNES,desnutricion aguda,desnutricion grave (g),2007-08-01,0,0,1,1,1,1,2
YACUIBA,desnutricion aguda,desnutricion grave (g),2007-08-01,2,2,0,1,2,3,5
YAMPARAEZ,desnutricion aguda,desnutricion grave (g),2007-08-01,1,1,3,0,4,1,5
YAPACANI,desnutricion aguda,desnutricion grave (g),2007-08-01,0,1,0,0,0,1,1
YOTALA,desnutricion aguda,desnutricion grave (g),2007-08-01,0,2,2,0,2,2,4
ZUDAÑEZ,desnutricion aguda,desnutricion grave (g),2007-08-01,2,1,0,1,2,2,4
ACACIO,desnutricion aguda,desnutricion grave (g),2007-09-01,1,3,1,2,2,5,7
AIQUILE,desnutricion aguda,desnutricion grave (g),2007-09-01,3,3,5,2,8,5,13
ALALAY,desnutricion aguda,desnutricion grave (g),2007-09-01,0,1,0,0,0,1,1
ALCALA,desnutricion aguda,desnutricion grave (g),2007-09-01,1,2,0,1,1,3,4
ANZALDO,desnutricion aguda,desnutricion grave (g),2007-09-01,2,0,0,1,2,1,3
ARAMPAMPA,desnutricion aguda,desnutricion grave (g),2007-09-01,3,3,0,1,3,4,7
ARANI,desnutricion aguda,desnutricion grave (g),2007-09-01,0,0,0,1,0,1,1
ATOCHA,desnutricion aguda,desnutricion grave (g),2007-09-01,1,0,1,0,2,0,2
AYOPAYA (V. DE INDEPENDENCIA),desnutricion aguda,desnutricion grave (g),2007-09-01,0,2,2,0,2,2,4
AZURDUY,desnutricion aguda,desnutricion grave (g),2007-09-01,2,8,1,2,3,10,13
BETANZOS,desnutricion aguda,desnutricion grave (g),2007-09-01,3,4,3,2,6,6,12
BOLIVAR,desnutricion aguda,desnutricion grave (g),2007-09-01,0,1,0,1,0,2,2
BUENA VISTA,desnutricion aguda,desnutricion grave (g),2007-09-01,1,0,0,0,1,0,1
"CAIZA ""D""",desnutricion aguda,desnutricion grave (g),2007-09-01,0,0,1,0,1,0,1
CAJUATA,desnutricion aguda,desnutricion grave (g),2007-09-01,1,1,0,0,1,1,2
CAMARGO,desnutricion aguda,desnutricion grave (g),2007-09-01,2,2,1,0,3,2,5
CAMATAQUI (C. VILLA ABECIA),desnutricion aguda,desnutricion grave (g),2007-09-01,0,0,0,1,0,1,1
CAMIRI,desnutricion aguda,desnutricion grave (g),2007-09-01,1,0,0,0,1,0,1
CARIPUYO,desnutricion aguda,desnutricion grave (g),2007-09-01,2,1,1,1,3,2,5
CARMEN RIVERO TORREZ,desnutricion aguda,desnutricion grave (g),2007-09-01,0,1,0,0,0,1,1
CHALLAPATA,desnutricion aguda,desnutricion grave (g),2007-09-01,2,0,0,0,2,0,2
CHAQUI,desnutricion aguda,desnutricion grave (g),2007-09-01,2,0,0,0,2,0,2
CHARAGUA,desnutricion aguda,desnutricion grave (g),2007-09-01,1,1,0,0,1,1,2
CHAYANTA,desnutricion aguda,desnutricion grave (g),2007-09-01,1,1,0,2,1,3,4
COBIJA,desnutricion aguda,desnutricion grave (g),2007-09-01,2,10,0,0,2,10,12
COCHABAMBA,desnutricion aguda,desnutricion grave (g),2007-09-01,12,10,0,1,12,11,23
COIPASA,desnutricion aguda,desnutricion grave (g),2007-09-01,0,0,1,0,1,0,1
COLCAPIRHUA,desnutricion aguda,desnutricion grave (g),2007-09-01,0,1,0,0,0,1,1
COLQUECHACA,desnutricion aguda,desnutricion grave (g),2007-09-01,3,2,0,1,3,3,6
COLQUIRI,desnutricion aguda,desnutricion grave (g),2007-09-01,0,0,0,1,0,1,1
CONCEPCION,desnutricion aguda,desnutricion grave (g),2007-09-01,0,1,0,0,0,1,1
COTAGAITA,desnutricion aguda,desnutricion grave (g),2007-09-01,4,3,0,0,4,3,7
COTOCA,desnutricion aguda,desnutricion grave (g),2007-09-01,2,1,1,1,3,2,5
CUEVO,desnutricion aguda,desnutricion grave (g),2007-09-01,0,0,1,0,1,0,1
CULPINA,desnutricion aguda,desnutricion grave (g),2007-09-01,7,2,3,2,10,4,14
EL TORNO,desnutricion aguda,desnutricion grave (g),2007-09-01,2,0,1,0,3,0,3
EL VILLAR,desnutricion aguda,desnutricion grave (g),2007-09-01,1,2,0,0,1,2,3
ENTRE RIOS,desnutricion aguda,desnutricion grave (g),2007-09-01,0,1,0,0,0,1,1
ENTRE RIOS,desnutricion aguda,desnutricion grave (g),2007-09-01,0,1,1,0,1,1,2
FERNANDEZ ALONSO,desnutricion aguda,desnutricion grave (g),2007-09-01,1,0,0,0,1,0,1
GENERAL SAAVEDRA,desnutricion aguda,desnutricion grave (g),2007-09-01,0,2,0,0,0,2,2
GUAYARAMERIN,desnutricion aguda,desnutricion grave (g),2007-09-01,4,0,0,0,4,0,4
GUTIERREZ,desnutricion aguda,desnutricion grave (g),2007-09-01,0,1,1,0,1,1,2
HUACARETA,desnutricion aguda,desnutricion grave (g),2007-09-01,0,0,0,1,0,1,1
HUACAYA (VILLA DE HUACAYA),desnutricion aguda,desnutricion grave (g),2007-09-01,1,0,0,1,1,1,2
HUANUNI,desnutricion aguda,desnutricion grave (g),2007-09-01,1,0,0,1,1,1,2
HUARACAJE,desnutricion aguda,desnutricion grave (g),2007-09-01,1,0,0,0,1,0,1
ICLA,desnutricion aguda,desnutricion grave (g),2007-09-01,5,8,2,3,7,11,18
INCAHUASI,desnutricion aguda,desnutricion grave (g),2007-09-01,1,4,0,2,1,6,7
INQUISIVI,desnutricion aguda,desnutricion grave (g),2007-09-01,3,0,1,0,4,0,4
LA GUARDIA,desnutricion aguda,desnutricion grave (g),2007-09-01,2,3,1,0,3,3,6
LA RIVERA,desnutricion aguda,desnutricion grave (g),2007-09-01,0,1,0,0,0,1,1
LLALLAGUA,desnutricion aguda,desnutricion grave (g),2007-09-01,4,1,2,0,6,1,7
LLICA,desnutricion aguda,desnutricion grave (g),2007-09-01,0,0,0,1,0,1,1
MINEROS,desnutricion aguda,desnutricion grave (g),2007-09-01,1,0,0,0,1,0,1
MIZQUE,desnutricion aguda,desnutricion grave (g),2007-09-01,0,4,0,0,0,4,4
MONTEAGUDO,desnutricion aguda,desnutricion grave (g),2007-09-01,0,2,2,3,2,5,7
MONTERO,desnutricion aguda,desnutricion grave (g),2007-09-01,5,6,1,1,6,7,13
MOROCHATA,desnutricion aguda,desnutricion grave (g),2007-09-01,1,1,0,1,1,2,3
OCURI,desnutricion aguda,desnutricion grave (g),2007-09-01,4,2,0,1,4,3,7
OKINAWA,desnutricion aguda,desnutricion grave (g),2007-09-01,0,0,1,1,1,1,2
ORURO,desnutricion aguda,desnutricion grave (g),2007-09-01,5,1,1,0,6,1,7
PAILON,desnutricion aguda,desnutricion grave (g),2007-09-01,1,1,0,1,1,2,3
PALCA,desnutricion aguda,desnutricion grave (g),2007-09-01,1,0,0,0,1,0,1
PASORAPA,desnutricion aguda,desnutricion grave (g),2007-09-01,0,1,0,0,0,1,1
PAZÑA,desnutricion aguda,desnutricion grave (g),2007-09-01,0,1,0,0,0,1,1
POCOATA,desnutricion aguda,desnutricion grave (g),2007-09-01,4,2,0,3,4,5,9
POJO (CBBA),desnutricion aguda,desnutricion grave (g),2007-09-01,2,0,0,1,2,1,3
PORCO,desnutricion aguda,desnutricion grave (g),2007-09-01,0,2,0,0,0,2,2
POROMA,desnutricion aguda,desnutricion grave (g),2007-09-01,4,15,2,8,6,23,29
PORONGO,desnutricion aguda,desnutricion grave (g),2007-09-01,0,1,2,0,2,1,3
PORTACHUELO,desnutricion aguda,desnutricion grave (g),2007-09-01,1,0,0,0,1,0,1
POTOSI,desnutricion aguda,desnutricion grave (g),2007-09-01,20,9,4,4,24,13,37
PRESTO,desnutricion aguda,desnutricion grave (g),2007-09-01,4,1,0,2,4,3,7
PUERTO GONZALO MORENO,desnutricion aguda,desnutricion grave (g),2007-09-01,2,3,2,0,4,3,7
PUERTO RICO,desnutricion aguda,desnutricion grave (g),2007-09-01,1,1,1,1,2,2,4
PUERTO SUAREZ,desnutricion aguda,desnutricion grave (g),2007-09-01,1,0,0,0,1,0,1
PUERTO VILLARROEL,desnutricion aguda,desnutricion grave (g),2007-09-01,5,3,2,0,7,3,10
PUNA,desnutricion aguda,desnutricion grave (g),2007-09-01,6,3,2,0,8,3,11
PUNATA,desnutricion aguda,desnutricion grave (g),2007-09-01,3,4,3,0,6,4,10
QUILLACOLLO,desnutricion aguda,desnutricion grave (g),2007-09-01,1,1,2,2,3,3,6
RAVELO,desnutricion aguda,desnutricion grave (g),2007-09-01,9,8,2,3,11,11,22
RIBERALTA,desnutricion aguda,desnutricion grave (g),2007-09-01,10,33,1,4,11,37,48
ROBORE,desnutricion aguda,desnutricion grave (g),2007-09-01,1,2,0,0,1,2,3
RURRENABAQUE,desnutricion aguda,desnutricion grave (g),2007-09-01,0,0,1,0,1,0,1
SACABA,desnutricion aguda,desnutricion grave (g),2007-09-01,1,1,3,1,4,2,6
SACACA,desnutricion aguda,desnutricion grave (g),2007-09-01,3,4,3,5,6,9,15
SAN ANTONIO DE LOMERIO,desnutricion aguda,desnutricion grave (g),2007-09-01,2,0,2,0,4,0,4
SAN BORJA,desnutricion aguda,desnutricion grave (g),2007-09-01,5,3,3,6,8,9,17
SAN CARLOS,desnutricion aguda,desnutricion grave (g),2007-09-01,1,2,1,0,2,2,4
SAN IGNACIO,desnutricion aguda,desnutricion grave (g),2007-09-01,3,2,1,1,4,3,7
SAN IGNACIO DE VELASCO,desnutricion aguda,desnutricion grave (g),2007-09-01,8,4,3,3,11,7,18
SAN JOSE DE CHIQUITOS,desnutricion aguda,desnutricion grave (g),2007-09-01,1,1,1,0,2,1,3
SAN JUAN DE YAPACANI,desnutricion aguda,desnutricion grave (g),2007-09-01,1,1,0,0,1,1,2
SAN LORENZO(TJA),desnutricion aguda,desnutricion grave (g),2007-09-01,3,1,0,0,3,1,4
SAN LUCAS,desnutricion aguda,desnutricion grave (g),2007-09-01,7,5,2,4,9,9,18
SAN PABLO DE LIPEZ,desnutricion aguda,desnutricion grave (g),2007-09-01,0,0,0,1,0,1,1
SAN PEDRO DE BUENA VISTA,desnutricion aguda,desnutricion grave (g),2007-09-01,2,4,2,3,4,7,11
SANTA CRUZ DE LA SIERRA,desnutricion aguda,desnutricion grave (g),2007-09-01,6,12,7,12,13,24,37
SANTA ROSA DEL SARA,desnutricion aguda,desnutricion grave (g),2007-09-01,0,1,0,0,0,1,1
SANTIAGO DE HUARI,desnutricion aguda,desnutricion grave (g),2007-09-01,0,1,0,0,0,1,1
SANTUARIO DE QUILLACAS,desnutricion aguda,desnutricion grave (g),2007-09-01,1,0,0,0,1,0,1
SIPE SIPE,desnutricion aguda,desnutricion grave (g),2007-09-01,2,1,0,1,2,2,4
SOPACHUY,desnutricion aguda,desnutricion grave (g),2007-09-01,2,7,2,1,4,8,12
SORACACHI,desnutricion aguda,desnutricion grave (g),2007-09-01,2,0,0,0,2,0,2
SUCRE,desnutricion aguda,desnutricion grave (g),2007-09-01,3,1,0,2,3,3,6
TACOBAMBA,desnutricion aguda,desnutricion grave (g),2007-09-01,4,1,0,0,4,1,5
TACOPAYA,desnutricion aguda,desnutricion grave (g),2007-09-01,0,2,1,0,1,2,3
TAPACARI,desnutricion aguda,desnutricion grave (g),2007-09-01,4,3,1,4,5,7,12
TARABUCO,desnutricion aguda,desnutricion grave (g),2007-09-01,15,5,2,4,17,9,26
TARATA,desnutricion aguda,desnutricion grave (g),2007-09-01,2,0,0,0,2,0,2
TARIJA,desnutricion aguda,desnutricion grave (g),2007-09-01,2,3,1,3,3,6,9
TARVITA,desnutricion aguda,desnutricion grave (g),2007-09-01,3,2,3,1,6,3,9
TINGUIPAYA,desnutricion aguda,desnutricion grave (g),2007-09-01,2,3,0,2,2,5,7
TIRAQUE (CBBA),desnutricion aguda,desnutricion grave (g),2007-09-01,4,16,2,0,6,16,22
TOMAVE,desnutricion aguda,desnutricion grave (g),2007-09-01,0,1,0,2,0,3,3
TOMINA,desnutricion aguda,desnutricion grave (g),2007-09-01,0,3,2,3,2,6,8
TORO TORO,desnutricion aguda,desnutricion grave (g),2007-09-01,7,6,9,7,16,13,29
TRINIDAD,desnutricion aguda,desnutricion grave (g),2007-09-01,4,3,2,1,6,4,10
TUPIZA,desnutricion aguda,desnutricion grave (g),2007-09-01,2,0,0,0,2,0,2
UNCIA,desnutricion aguda,desnutricion grave (g),2007-09-01,3,2,0,1,3,3,6
URIONDO (A. CONCEPCION),desnutricion aguda,desnutricion grave (g),2007-09-01,1,0,0,0,1,0,1
UYUNI,desnutricion aguda,desnutricion grave (g),2007-09-01,1,0,1,0,2,0,2
VACAS,desnutricion aguda,desnutricion grave (g),2007-09-01,0,1,0,0,0,1,1
VIACHA,desnutricion aguda,desnutricion grave (g),2007-09-01,0,0,0,1,0,1,1
VILLA RIVERO,desnutricion aguda,desnutricion grave (g),2007-09-01,1,2,0,0,1,2,3
VILLA SERRANO,desnutricion aguda,desnutricion grave (g),2007-09-01,0,0,1,0,1,0,1
VILLA TUNARI,desnutricion aguda,desnutricion grave (g),2007-09-01,3,3,1,0,4,3,7
VILLAZON,desnutricion aguda,desnutricion grave (g),2007-09-01,0,1,0,0,0,1,1
VINTO,desnutricion aguda,desnutricion grave (g),2007-09-01,0,0,1,0,1,0,1
VITICHI,desnutricion aguda,desnutricion grave (g),2007-09-01,3,1,0,1,3,2,5
WARNES,desnutricion aguda,desnutricion grave (g),2007-09-01,2,1,0,0,2,1,3
YACUIBA,desnutricion aguda,desnutricion grave (g),2007-09-01,1,2,1,0,2,2,4
YAMPARAEZ,desnutricion aguda,desnutricion grave (g),2007-09-01,0,0,3,2,3,2,5
YOTALA,desnutricion aguda,desnutricion grave (g),2007-09-01,2,2,2,2,4,4,8
ZUDAÑEZ,desnutricion aguda,desnutricion grave (g),2007-09-01,2,0,1,0,3,0,3
ACACIO,desnutricion aguda,desnutricion grave (g),2007-10-01,1,3,1,2,2,5,7
ACHOCALLA,desnutricion aguda,desnutricion grave (g),2007-10-01,0,0,0,1,0,1,1
AIQUILE,desnutricion aguda,desnutricion grave (g),2007-10-01,0,5,0,2,0,7,7
ALALAY,desnutricion aguda,desnutricion grave (g),2007-10-01,0,1,0,0,0,1,1
ANZALDO,desnutricion aguda,desnutricion grave (g),2007-10-01,1,0,0,0,1,0,1
ARAMPAMPA,desnutricion aguda,desnutricion grave (g),2007-10-01,10,3,1,2,11,5,16
ARQUE,desnutricion aguda,desnutricion grave (g),2007-10-01,1,1,0,0,1,1,2
ASCENCION DE GUARAYOS,desnutricion aguda,desnutricion grave (g),2007-10-01,2,2,3,0,5,2,7
AYOPAYA (V. DE INDEPENDENCIA),desnutricion aguda,desnutricion grave (g),2007-10-01,3,3,2,3,5,6,11
AZURDUY,desnutricion aguda,desnutricion grave (g),2007-10-01,3,5,0,2,3,7,10
BAURES,desnutricion aguda,desnutricion grave (g),2007-10-01,0,0,1,0,1,0,1
BELEN DE URMIRI,desnutricion aguda,desnutricion grave (g),2007-10-01,0,1,0,0,0,1,1
BERMEJO,desnutricion aguda,desnutricion grave (g),2007-10-01,0,1,0,0,0,1,1
BETANZOS,desnutricion aguda,desnutricion grave (g),2007-10-01,5,14,1,3,6,17,23
BOLIVAR,desnutricion aguda,desnutricion grave (g),2007-10-01,1,3,0,1,1,4,5
CAMARGO,desnutricion aguda,desnutricion grave (g),2007-10-01,2,4,0,3,2,7,9
CAMATAQUI (C. VILLA ABECIA),desnutricion aguda,desnutricion grave (g),2007-10-01,0,0,0,1,0,1,1
CAMIRI,desnutricion aguda,desnutricion grave (g),2007-10-01,2,0,1,0,3,0,3
CAPINOTA,desnutricion aguda,desnutricion grave (g),2007-10-01,5,1,0,0,5,1,6
CARAPARI,desnutricion aguda,desnutricion grave (g),2007-10-01,0,1,0,1,0,2,2
CARIPUYO,desnutricion aguda,desnutricion grave (g),2007-10-01,1,2,0,1,1,3,4
CHALLAPATA,desnutricion aguda,desnutricion grave (g),2007-10-01,3,0,3,3,6,3,9
CHAYANTA,desnutricion aguda,desnutricion grave (g),2007-10-01,0,2,2,0,2,2,4
CHIMORE,desnutricion aguda,desnutricion grave (g),2007-10-01,1,0,0,0,1,0,1
COBIJA,desnutricion aguda,desnutricion grave (g),2007-10-01,2,2,0,0,2,2,4
COCHABAMBA,desnutricion aguda,desnutricion grave (g),2007-10-01,6,6,2,4,8,10,18
"COLCHA ""K""",desnutricion aguda,desnutricion grave (g),2007-10-01,1,0,0,0,1,0,1
COLOMI,desnutricion aguda,desnutricion grave (g),2007-10-01,1,1,0,0,1,1,2
COLQUECHACA,desnutricion aguda,desnutricion grave (g),2007-10-01,3,6,4,4,7,10,17
COLQUIRI,desnutricion aguda,desnutricion grave (g),2007-10-01,0,2,0,0,0,2,2
COMARAPA,desnutricion aguda,desnutricion grave (g),2007-10-01,1,2,0,0,1,2,3
CONCEPCION,desnutricion aguda,desnutricion grave (g),2007-10-01,1,2,0,0,1,2,3
COTAGAITA,desnutricion aguda,desnutricion grave (g),2007-10-01,3,3,1,2,4,5,9
COTOCA,desnutricion aguda,desnutricion grave (g),2007-10-01,0,3,0,1,0,4,4
CUATRO CAÑADAS,desnutricion aguda,desnutricion grave (g),2007-10-01,0,1,0,0,0,1,1
CUEVO,desnutricion aguda,desnutricion grave (g),2007-10-01,0,0,1,0,1,0,1
CULPINA,desnutricion aguda,desnutricion grave (g),2007-10-01,4,0,0,1,4,1,5
EL TORNO,desnutricion aguda,desnutricion grave (g),2007-10-01,1,0,0,0,1,0,1
ENTRE RIOS,desnutricion aguda,desnutricion grave (g),2007-10-01,1,0,0,0,1,0,1
EUCALIPTUS,desnutricion aguda,desnutricion grave (g),2007-10-01,0,0,1,0,1,0,1
EXALTACION,desnutricion aguda,desnutricion grave (g),2007-10-01,0,1,1,0,1,1,2
FERNANDEZ ALONSO,desnutricion aguda,desnutricion grave (g),2007-10-01,1,0,0,0,1,0,1
GENERAL SAAVEDRA,desnutricion aguda,desnutricion grave (g),2007-10-01,0,1,1,0,1,1,2
GUAYARAMERIN,desnutricion aguda,desnutricion grave (g),2007-10-01,5,5,0,2,5,7,12
GUTIERREZ,desnutricion aguda,desnutricion grave (g),2007-10-01,1,2,0,0,1,2,3
HUACARETA,desnutricion aguda,desnutricion grave (g),2007-10-01,0,2,0,2,0,4,4
HUANUNI,desnutricion aguda,desnutricion grave (g),2007-10-01,1,1,0,0,1,1,2
ICLA,desnutricion aguda,desnutricion grave (g),2007-10-01,4,9,1,5,5,14,19
INCAHUASI,desnutricion aguda,desnutricion grave (g),2007-10-01,3,5,0,1,3,6,9
INQUISIVI,desnutricion aguda,desnutricion grave (g),2007-10-01,0,1,2,0,2,1,3
LA GUARDIA,desnutricion aguda,desnutricion grave (g),2007-10-01,3,3,2,1,5,4,9
LAGUNILLAS,desnutricion aguda,desnutricion grave (g),2007-10-01,0,1,0,1,0,2,2
LAS CARRERAS,desnutricion aguda,desnutricion grave (g),2007-10-01,0,1,0,1,0,2,2
LLALLAGUA,desnutricion aguda,desnutricion grave (g),2007-10-01,0,0,3,1,3,1,4
MACHARETI,desnutricion aguda,desnutricion grave (g),2007-10-01,1,0,2,1,3,1,4
MINEROS,desnutricion aguda,desnutricion grave (g),2007-10-01,0,1,0,0,0,1,1
MIZQUE,desnutricion aguda,desnutricion grave (g),2007-10-01,2,1,1,0,3,1,4
MOJOCOYA,desnutricion aguda,desnutricion grave (g),2007-10-01,1,0,0,1,1,1,2
MONTEAGUDO,desnutricion aguda,desnutricion grave (g),2007-10-01,1,2,3,1,4,3,7
MONTERO,desnutricion aguda,desnutricion grave (g),2007-10-01,1,4,4,2,5,6,11
MOROCHATA,desnutricion aguda,desnutricion grave (g),2007-10-01,1,0,0,1,1,1,2
OCURI,desnutricion aguda,desnutricion grave (g),2007-10-01,6,5,3,2,9,7,16
ORURO,desnutricion aguda,desnutricion grave (g),2007-10-01,4,1,1,0,5,1,6
PADCAYA,desnutricion aguda,desnutricion grave (g),2007-10-01,0,1,0,0,0,1,1
PADILLA,desnutricion aguda,desnutricion grave (g),2007-10-01,2,0,0,0,2,0,2
PAILON,desnutricion aguda,desnutricion grave (g),2007-10-01,3,3,1,0,4,3,7
PALCA,desnutricion aguda,desnutricion grave (g),2007-10-01,3,0,0,0,3,0,3
POCOATA,desnutricion aguda,desnutricion grave (g),2007-10-01,2,2,2,1,4,3,7
POCONA,desnutricion aguda,desnutricion grave (g),2007-10-01,1,0,0,0,1,0,1
POJO (CBBA),desnutricion aguda,desnutricion grave (g),2007-10-01,1,1,0,0,1,1,2
PORCO,desnutricion aguda,desnutricion grave (g),2007-10-01,1,2,0,0,1,2,3
POROMA,desnutricion aguda,desnutricion grave (g),2007-10-01,5,12,5,6,10,18,28
PORTACHUELO,desnutricion aguda,desnutricion grave (g),2007-10-01,0,0,1,0,1,0,1
POSTRER VALLE,desnutricion aguda,desnutricion grave (g),2007-10-01,0,1,2,0,2,1,3
POTOSI,desnutricion aguda,desnutricion grave (g),2007-10-01,5,17,3,4,8,21,29
PRESTO,desnutricion aguda,desnutricion grave (g),2007-10-01,3,0,1,2,4,2,6
PUCARA,desnutricion aguda,desnutricion grave (g),2007-10-01,1,0,0,0,1,0,1
PUERTO GONZALO MORENO,desnutricion aguda,desnutricion grave (g),2007-10-01,3,1,1,0,4,1,5
PUERTO QUIJARRO,desnutricion aguda,desnutricion grave (g),2007-10-01,1,0,0,0,1,0,1
PUERTO RICO,desnutricion aguda,desnutricion grave (g),2007-10-01,1,2,0,0,1,2,3
PUERTO SUAREZ,desnutricion aguda,desnutricion grave (g),2007-10-01,2,2,0,0,2,2,4
PUERTO VILLARROEL,desnutricion aguda,desnutricion grave (g),2007-10-01,4,3,3,2,7,5,12
PUNA,desnutricion aguda,desnutricion grave (g),2007-10-01,3,2,0,0,3,2,5
PUNATA,desnutricion aguda,desnutricion grave (g),2007-10-01,8,8,0,4,8,12,20
QUILLACOLLO,desnutricion aguda,desnutricion grave (g),2007-10-01,2,3,1,0,3,3,6
QUIME,desnutricion aguda,desnutricion grave (g),2007-10-01,0,1,0,1,0,2,2
RAVELO,desnutricion aguda,desnutricion grave (g),2007-10-01,6,8,5,5,11,13,24
REYES,desnutricion aguda,desnutricion grave (g),2007-10-01,0,1,0,0,0,1,1
RIBERALTA,desnutricion aguda,desnutricion grave (g),2007-10-01,9,23,1,3,10,26,36
ROBORE,desnutricion aguda,desnutricion grave (g),2007-10-01,1,1,0,0,1,1,2
SACABA,desnutricion aguda,desnutricion grave (g),2007-10-01,2,1,1,2,3,3,6
SACABAMBA,desnutricion aguda,desnutricion grave (g),2007-10-01,1,0,0,0,1,0,1
SACACA,desnutricion aguda,desnutricion grave (g),2007-10-01,5,4,4,0,9,4,13
SAN ANTONIO DE LOMERIO,desnutricion aguda,desnutricion grave (g),2007-10-01,2,0,1,1,3,1,4
SAN BENITO,desnutricion aguda,desnutricion grave (g),2007-10-01,0,2,0,0,0,2,2
SAN BORJA,desnutricion aguda,desnutricion grave (g),2007-10-01,1,1,13,2,14,3,17
SAN CARLOS,desnutricion aguda,desnutricion grave (g),2007-10-01,3,2,2,0,5,2,7
SAN IGNACIO,desnutricion aguda,desnutricion grave (g),2007-10-01,2,3,0,0,2,3,5
SAN IGNACIO DE VELASCO,desnutricion aguda,desnutricion grave (g),2007-10-01,5,6,2,3,7,9,16
SAN JOSE DE CHIQUITOS,desnutricion aguda,desnutricion grave (g),2007-10-01,2,1,0,1,2,2,4
SAN JUAN DE YAPACANI,desnutricion aguda,desnutricion grave (g),2007-10-01,1,1,0,0,1,1,2
SAN JULIAN,desnutricion aguda,desnutricion grave (g),2007-10-01,2,0,0,0,2,0,2
SAN LORENZO(PND),desnutricion aguda,desnutricion grave (g),2007-10-01,0,1,0,0,0,1,1
SAN LUCAS,desnutricion aguda,desnutricion grave (g),2007-10-01,6,6,4,1,10,7,17
SAN MIGUEL DE VELASCO,desnutricion aguda,desnutricion grave (g),2007-10-01,1,0,0,0,1,0,1
SAN PEDRO,desnutricion aguda,desnutricion grave (g),2007-10-01,0,0,0,2,0,2,2
SAN PEDRO DE BUENA VISTA,desnutricion aguda,desnutricion grave (g),2007-10-01,5,8,2,2,7,10,17
SAN PEDRO(PND),desnutricion aguda,desnutricion grave (g),2007-10-01,1,0,0,1,1,1,2
SAN RAFAEL,desnutricion aguda,desnutricion grave (g),2007-10-01,0,0,0,1,0,1,1
SAN RAMON,desnutricion aguda,desnutricion grave (g),2007-10-01,0,0,0,1,0,1,1
SANTA ANA,desnutricion aguda,desnutricion grave (g),2007-10-01,2,0,0,1,2,1,3
SANTA CRUZ DE LA SIERRA,desnutricion aguda,desnutricion grave (g),2007-10-01,6,6,1,4,7,10,17
SANTA ROSA,desnutricion aguda,desnutricion grave (g),2007-10-01,1,1,0,0,1,1,2
SANTA ROSA DEL SARA,desnutricion aguda,desnutricion grave (g),2007-10-01,1,0,0,3,1,3,4
SANTIAGO DE HUARI,desnutricion aguda,desnutricion grave (g),2007-10-01,1,1,1,0,2,1,3
SANTUARIO DE QUILLACAS,desnutricion aguda,desnutricion grave (g),2007-10-01,1,0,0,0,1,0,1
SENA,desnutricion aguda,desnutricion grave (g),2007-10-01,1,0,0,0,1,0,1
SICAYA,desnutricion aguda,desnutricion grave (g),2007-10-01,0,1,0,0,0,1,1
SIPE SIPE,desnutricion aguda,desnutricion grave (g),2007-10-01,0,1,0,0,0,1,1
SOPACHUY,desnutricion aguda,desnutricion grave (g),2007-10-01,1,4,1,2,2,6,8
SUCRE,desnutricion aguda,desnutricion grave (g),2007-10-01,4,8,1,8,5,16,21
TACOBAMBA,desnutricion aguda,desnutricion grave (g),2007-10-01,2,8,2,4,4,12,16
TACOPAYA,desnutricion aguda,desnutricion grave (g),2007-10-01,2,2,0,0,2,2,4
TAPACARI,desnutricion aguda,desnutricion grave (g),2007-10-01,5,4,2,3,7,7,14
TARABUCO,desnutricion aguda,desnutricion grave (g),2007-10-01,12,16,5,7,17,23,40
TARATA,desnutricion aguda,desnutricion grave (g),2007-10-01,1,0,0,0,1,0,1
TARIJA,desnutricion aguda,desnutricion grave (g),2007-10-01,4,7,1,2,5,9,14
TARVITA,desnutricion aguda,desnutricion grave (g),2007-10-01,1,2,0,4,1,6,7
TINGUIPAYA,desnutricion aguda,desnutricion grave (g),2007-10-01,4,10,3,3,7,13,20
TIQUIPAYA,desnutricion aguda,desnutricion grave (g),2007-10-01,0,1,0,0,0,1,1
TIRAQUE (CBBA),desnutricion aguda,desnutricion grave (g),2007-10-01,6,4,6,0,12,4,16
TOMAVE,desnutricion aguda,desnutricion grave (g),2007-10-01,0,1,1,0,1,1,2
TOMINA,desnutricion aguda,desnutricion grave (g),2007-10-01,0,3,1,3,1,6,7
TORO TORO,desnutricion aguda,desnutricion grave (g),2007-10-01,2,3,2,1,4,4,8
TOTORA(CBBA),desnutricion aguda,desnutricion grave (g),2007-10-01,3,4,0,0,3,4,7
TOTORA(ORR),desnutricion aguda,desnutricion grave (g),2007-10-01,0,1,0,0,0,1,1
TRINIDAD,desnutricion aguda,desnutricion grave (g),2007-10-01,3,4,0,0,3,4,7
TUPIZA,desnutricion aguda,desnutricion grave (g),2007-10-01,0,1,1,0,1,1,2
UNCIA,desnutricion aguda,desnutricion grave (g),2007-10-01,1,5,0,1,1,6,7
URIONDO (A. CONCEPCION),desnutricion aguda,desnutricion grave (g),2007-10-01,1,0,0,0,1,0,1
UYUNI,desnutricion aguda,desnutricion grave (g),2007-10-01,0,1,0,0,0,1,1
VILLA MONTES,desnutricion aguda,desnutricion grave (g),2007-10-01,4,0,1,0,5,0,5
VILLA SERRANO,desnutricion aguda,desnutricion grave (g),2007-10-01,0,0,1,0,1,0,1
VILLA TUNARI,desnutricion aguda,desnutricion grave (g),2007-10-01,2,7,0,0,2,7,9
VILLAZON,desnutricion aguda,desnutricion grave (g),2007-10-01,1,3,1,0,2,3,5
VITICHI,desnutricion aguda,desnutricion grave (g),2007-10-01,1,1,0,2,1,3,4
YACUIBA,desnutricion aguda,desnutricion grave (g),2007-10-01,0,3,0,1,0,4,4
YAMPARAEZ,desnutricion aguda,desnutricion grave (g),2007-10-01,2,0,4,0,6,0,6
YAPACANI,desnutricion aguda,desnutricion grave (g),2007-10-01,1,0,0,1,1,1,2
YUNCHARA,desnutricion aguda,desnutricion grave (g),2007-10-01,2,0,3,0,5,0,5
ZUDAÑEZ,desnutricion aguda,desnutricion grave (g),2007-10-01,0,0,3,3,3,3,6
ACACIO,desnutricion aguda,desnutricion grave (g),2007-11-01,0,1,1,3,1,4,5
AIQUILE,desnutricion aguda,desnutricion grave (g),2007-11-01,5,5,0,1,5,6,11
ARAMPAMPA,desnutricion aguda,desnutricion grave (g),2007-11-01,6,3,0,2,6,5,11
ARANI,desnutricion aguda,desnutricion grave (g),2007-11-01,1,0,0,0,1,0,1
ARQUE,desnutricion aguda,desnutricion grave (g),2007-11-01,2,2,0,1,2,3,5
AZURDUY,desnutricion aguda,desnutricion grave (g),2007-11-01,1,3,1,3,2,6,8
BELLA FLOR,desnutricion aguda,desnutricion grave (g),2007-11-01,0,0,1,0,1,0,1
BERMEJO,desnutricion aguda,desnutricion grave (g),2007-11-01,0,1,1,0,1,1,2
BETANZOS,desnutricion aguda,desnutricion grave (g),2007-11-01,5,7,1,3,6,10,16
BOLIVAR,desnutricion aguda,desnutricion grave (g),2007-11-01,4,4,1,3,5,7,12
CAMARGO,desnutricion aguda,desnutricion grave (g),2007-11-01,1,2,0,2,1,4,5
CAMATAQUI (C. VILLA ABECIA),desnutricion aguda,desnutricion grave (g),2007-11-01,0,0,0,1,0,1,1
CAMIRI,desnutricion aguda,desnutricion grave (g),2007-11-01,0,1,0,0,0,1,1
CAPINOTA,desnutricion aguda,desnutricion grave (g),2007-11-01,1,0,1,0,2,0,2
CARACOLLO,desnutricion aguda,desnutricion grave (g),2007-11-01,0,2,0,0,0,2,2
CARIPUYO,desnutricion aguda,desnutricion grave (g),2007-11-01,2,5,1,1,3,6,9
CHALLAPATA,desnutricion aguda,desnutricion grave (g),2007-11-01,2,0,1,0,3,0,3
CHARAGUA,desnutricion aguda,desnutricion grave (g),2007-11-01,1,1,0,0,1,1,2
CHAYANTA,desnutricion aguda,desnutricion grave (g),2007-11-01,2,0,3,1,5,1,6
CHIMORE,desnutricion aguda,desnutricion grave (g),2007-11-01,1,0,0,0,1,0,1
COBIJA,desnutricion aguda,desnutricion grave (g),2007-11-01,6,4,2,0,8,4,12
COCHABAMBA,desnutricion aguda,desnutricion grave (g),2007-11-01,11,4,3,5,14,9,23
COLCAPIRHUA,desnutricion aguda,desnutricion grave (g),2007-11-01,1,0,0,0,1,0,1
COLOMI,desnutricion aguda,desnutricion grave (g),2007-11-01,1,0,0,1,1,1,2
COLQUECHACA,desnutricion aguda,desnutricion grave (g),2007-11-01,3,3,2,4,5,7,12
COLQUIRI,desnutricion aguda,desnutricion grave (g),2007-11-01,1,1,0,0,1,1,2
COMARAPA,desnutricion aguda,desnutricion grave (g),2007-11-01,2,0,1,0,3,0,3
CONCEPCION,desnutricion aguda,desnutricion grave (g),2007-11-01,2,0,0,0,2,0,2
CORQUE,desnutricion aguda,desnutricion grave (g),2007-11-01,0,1,0,0,0,1,1
COTAGAITA,desnutricion aguda,desnutricion grave (g),2007-11-01,3,3,1,2,4,5,9
COTOCA,desnutricion aguda,desnutricion grave (g),2007-11-01,0,1,1,2,1,3,4
CUCHUMUELA (V. G. VILLARROEL),desnutricion aguda,desnutricion grave (g),2007-11-01,0,1,0,0,0,1,1
CUEVO,desnutricion aguda,desnutricion grave (g),2007-11-01,0,0,1,0,1,0,1
CULPINA,desnutricion aguda,desnutricion grave (g),2007-11-01,1,2,0,0,1,2,3
EL TORNO,desnutricion aguda,desnutricion grave (g),2007-11-01,1,0,0,0,1,0,1
EL VILLAR,desnutricion aguda,desnutricion grave (g),2007-11-01,0,2,0,1,0,3,3
ENTRE RIOS,desnutricion aguda,desnutricion grave (g),2007-11-01,0,1,0,1,0,2,2
GENERAL SAAVEDRA,desnutricion aguda,desnutricion grave (g),2007-11-01,0,1,0,0,0,1,1
GUAYARAMERIN,desnutricion aguda,desnutricion grave (g),2007-11-01,0,2,1,0,1,2,3
GUTIERREZ,desnutricion aguda,desnutricion grave (g),2007-11-01,2,1,1,1,3,2,5
HUARACAJE,desnutricion aguda,desnutricion grave (g),2007-11-01,0,0,0,1,0,1,1
ICLA,desnutricion aguda,desnutricion grave (g),2007-11-01,5,4,2,5,7,9,16
INCAHUASI,desnutricion aguda,desnutricion grave (g),2007-11-01,0,3,0,2,0,5,5
INQUISIVI,desnutricion aguda,desnutricion grave (g),2007-11-01,2,0,0,1,2,1,3
LA GUARDIA,desnutricion aguda,desnutricion grave (g),2007-11-01,1,1,3,1,4,2,6
LAGUNILLAS,desnutricion aguda,desnutricion grave (g),2007-11-01,1,1,0,0,1,1,2
LLALLAGUA,desnutricion aguda,desnutricion grave (g),2007-11-01,2,2,0,0,2,2,4
MAIRANA,desnutricion aguda,desnutricion grave (g),2007-11-01,0,1,0,0,0,1,1
MINEROS,desnutricion aguda,desnutricion grave (g),2007-11-01,1,1,0,0,1,1,2
MIZQUE,desnutricion aguda,desnutricion grave (g),2007-11-01,6,5,0,3,6,8,14
MOJOCOYA,desnutricion aguda,desnutricion grave (g),2007-11-01,1,0,0,0,1,0,1
MONTEAGUDO,desnutricion aguda,desnutricion grave (g),2007-11-01,4,2,1,2,5,4,9
MONTERO,desnutricion aguda,desnutricion grave (g),2007-11-01,6,1,0,1,6,2,8
MOROCHATA,desnutricion aguda,desnutricion grave (g),2007-11-01,2,1,0,1,2,2,4
OCURI,desnutricion aguda,desnutricion grave (g),2007-11-01,4,6,1,0,5,6,11
ORURO,desnutricion aguda,desnutricion grave (g),2007-11-01,3,4,1,2,4,6,10
PAILON,desnutricion aguda,desnutricion grave (g),2007-11-01,2,2,1,0,3,2,5
PALCA,desnutricion aguda,desnutricion grave (g),2007-11-01,0,1,1,0,1,1,2
PAZÑA,desnutricion aguda,desnutricion grave (g),2007-11-01,0,1,0,0,0,1,1
POCOATA,desnutricion aguda,desnutricion grave (g),2007-11-01,4,4,0,2,4,6,10
POCONA,desnutricion aguda,desnutricion grave (g),2007-11-01,0,2,1,0,1,2,3
POJO (CBBA),desnutricion aguda,desnutricion grave (g),2007-11-01,1,0,0,0,1,0,1
PORCO,desnutricion aguda,desnutricion grave (g),2007-11-01,0,0,0,1,0,1,1
POROMA,desnutricion aguda,desnutricion grave (g),2007-11-01,5,4,4,5,9,9,18
PORONGO,desnutricion aguda,desnutricion grave (g),2007-11-01,1,0,0,0,1,0,1
PORTACHUELO,desnutricion aguda,desnutricion grave (g),2007-11-01,1,1,1,0,2,1,3
PORVENIR,desnutricion aguda,desnutricion grave (g),2007-11-01,1,0,0,0,1,0,1
POTOSI,desnutricion aguda,desnutricion grave (g),2007-11-01,4,5,2,1,6,6,12
PRESTO,desnutricion aguda,desnutricion grave (g),2007-11-01,3,1,1,1,4,2,6
PUERTO GONZALO MORENO,desnutricion aguda,desnutricion grave (g),2007-11-01,3,0,3,0,6,0,6
PUERTO SUAREZ,desnutricion aguda,desnutricion grave (g),2007-11-01,1,2,0,0,1,2,3
PUERTO VILLARROEL,desnutricion aguda,desnutricion grave (g),2007-11-01,4,3,3,2,7,5,12
PUNA,desnutricion aguda,desnutricion grave (g),2007-11-01,8,6,2,5,10,11,21
PUNATA,desnutricion aguda,desnutricion grave (g),2007-11-01,6,8,10,3,16,11,27
QUILLACOLLO,desnutricion aguda,desnutricion grave (g),2007-11-01,1,0,1,1,2,1,3
QUIRUSILLAS,desnutricion aguda,desnutricion grave (g),2007-11-01,1,0,0,0,1,0,1
RAVELO,desnutricion aguda,desnutricion grave (g),2007-11-01,4,5,1,1,5,6,11
RIBERALTA,desnutricion aguda,desnutricion grave (g),2007-11-01,23,17,0,7,23,24,47
ROBORE,desnutricion aguda,desnutricion grave (g),2007-11-01,0,1,0,0,0,1,1
RURRENABAQUE,desnutricion aguda,desnutricion grave (g),2007-11-01,0,0,1,0,1,0,1
SACABA,desnutricion aguda,desnutricion grave (g),2007-11-01,4,3,1,0,5,3,8
SACABAMBA,desnutricion aguda,desnutricion grave (g),2007-11-01,1,0,0,0,1,0,1
SACACA,desnutricion aguda,desnutricion grave (g),2007-11-01,4,2,2,1,6,3,9
SAIPINA,desnutricion aguda,desnutricion grave (g),2007-11-01,0,0,1,1,1,1,2
SAN BORJA,desnutricion aguda,desnutricion grave (g),2007-11-01,1,2,1,0,2,2,4
SAN CARLOS,desnutricion aguda,desnutricion grave (g),2007-11-01,3,1,1,3,4,4,8
SAN IGNACIO,desnutricion aguda,desnutricion grave (g),2007-11-01,3,5,0,0,3,5,8
SAN IGNACIO DE VELASCO,desnutricion aguda,desnutricion grave (g),2007-11-01,6,11,2,4,8,15,23
SAN JOSE DE CHIQUITOS,desnutricion aguda,desnutricion grave (g),2007-11-01,0,2,1,0,1,2,3
SAN JUAN DE YAPACANI,desnutricion aguda,desnutricion grave (g),2007-11-01,1,0,0,0,1,0,1
SAN JULIAN,desnutricion aguda,desnutricion grave (g),2007-11-01,1,0,1,0,2,0,2
SAN LORENZO(PND),desnutricion aguda,desnutricion grave (g),2007-11-01,2,0,0,0,2,0,2
SAN LUCAS,desnutricion aguda,desnutricion grave (g),2007-11-01,10,10,0,1,10,11,21
SAN PEDRO DE BUENA VISTA,desnutricion aguda,desnutricion grave (g),2007-11-01,1,2,0,0,1,2,3
SAN RAFAEL,desnutricion aguda,desnutricion grave (g),2007-11-01,0,0,1,0,1,0,1
SANTA ANA,desnutricion aguda,desnutricion grave (g),2007-11-01,0,1,0,0,0,1,1
SANTA CRUZ DE LA SIERRA,desnutricion aguda,desnutricion grave (g),2007-11-01,5,4,1,1,6,5,11
SANTA ROSA,desnutricion aguda,desnutricion grave (g),2007-11-01,2,1,0,0,2,1,3
SANTA ROSA DEL SARA,desnutricion aguda,desnutricion grave (g),2007-11-01,2,1,1,1,3,2,5
SANTIAGO DE HUARI,desnutricion aguda,desnutricion grave (g),2007-11-01,2,5,2,1,4,6,10
SIPE SIPE,desnutricion aguda,desnutricion grave (g),2007-11-01,5,0,1,0,6,0,6
SOPACHUY,desnutricion aguda,desnutricion grave (g),2007-11-01,3,6,1,2,4,8,12
SORACACHI,desnutricion aguda,desnutricion grave (g),2007-11-01,1,1,0,0,1,1,2
SUCRE,desnutricion aguda,desnutricion grave (g),2007-11-01,7,2,1,3,8,5,13
TACOBAMBA,desnutricion aguda,desnutricion grave (g),2007-11-01,2,0,2,2,4,2,6
TACOPAYA,desnutricion aguda,desnutricion grave (g),2007-11-01,1,0,0,0,1,0,1
TAPACARI,desnutricion aguda,desnutricion grave (g),2007-11-01,5,4,3,2,8,6,14
TARABUCO,desnutricion aguda,desnutricion grave (g),2007-11-01,7,4,2,4,9,8,17
TARATA,desnutricion aguda,desnutricion grave (g),2007-11-01,1,0,0,0,1,0,1
TARIJA,desnutricion aguda,desnutricion grave (g),2007-11-01,1,1,1,1,2,2,4
TARVITA,desnutricion aguda,desnutricion grave (g),2007-11-01,2,6,4,3,6,9,15
TINGUIPAYA,desnutricion aguda,desnutricion grave (g),2007-11-01,1,3,2,0,3,3,6
TIRAQUE (CBBA),desnutricion aguda,desnutricion grave (g),2007-11-01,4,1,1,1,5,2,7
TOCO,desnutricion aguda,desnutricion grave (g),2007-11-01,2,0,0,0,2,0,2
TOLATA,desnutricion aguda,desnutricion grave (g),2007-11-01,0,1,0,0,0,1,1
TOMAVE,desnutricion aguda,desnutricion grave (g),2007-11-01,0,1,1,0,1,1,2
TOMINA,desnutricion aguda,desnutricion grave (g),2007-11-01,3,1,2,2,5,3,8
TORO TORO,desnutricion aguda,desnutricion grave (g),2007-11-01,4,2,3,2,7,4,11
TOTORA(CBBA),desnutricion aguda,desnutricion grave (g),2007-11-01,3,0,0,0,3,0,3
TOTORA(ORR),desnutricion aguda,desnutricion grave (g),2007-11-01,0,1,0,0,0,1,1
TRINIDAD,desnutricion aguda,desnutricion grave (g),2007-11-01,0,5,1,0,1,5,6
TUPIZA,desnutricion aguda,desnutricion grave (g),2007-11-01,1,0,0,0,1,0,1
UNCIA,desnutricion aguda,desnutricion grave (g),2007-11-01,3,2,0,0,3,2,5
URIONDO (A. CONCEPCION),desnutricion aguda,desnutricion grave (g),2007-11-01,1,0,0,0,1,0,1
UYUNI,desnutricion aguda,desnutricion grave (g),2007-11-01,0,0,1,0,1,0,1
VACAS,desnutricion aguda,desnutricion grave (g),2007-11-01,1,1,0,0,1,1,2
VILA VILA,desnutricion aguda,desnutricion grave (g),2007-11-01,1,1,0,0,1,1,2
VILLA MONTES,desnutricion aguda,desnutricion grave (g),2007-11-01,1,0,0,0,1,0,1
VILLA RIVERO,desnutricion aguda,desnutricion grave (g),2007-11-01,1,1,0,0,1,1,2
VILLA SERRANO,desnutricion aguda,desnutricion grave (g),2007-11-01,0,1,0,0,0,1,1
VILLA TUNARI,desnutricion aguda,desnutricion grave (g),2007-11-01,5,2,3,1,8,3,11
VILLAZON,desnutricion aguda,desnutricion grave (g),2007-11-01,0,0,0,1,0,1,1
VITICHI,desnutricion aguda,desnutricion grave (g),2007-11-01,4,1,1,1,5,2,7
WARNES,desnutricion aguda,desnutricion grave (g),2007-11-01,0,1,0,1,0,2,2
YAMPARAEZ,desnutricion aguda,desnutricion grave (g),2007-11-01,2,0,2,0,4,0,4
YAPACANI,desnutricion aguda,desnutricion grave (g),2007-11-01,0,1,0,2,0,3,3
YUNCHARA,desnutricion aguda,desnutricion grave (g),2007-11-01,1,0,0,0,1,0,1
ZUDAÑEZ,desnutricion aguda,desnutricion grave (g),2007-11-01,0,0,1,0,1,0,1
ACACIO,desnutricion aguda,desnutricion grave (g),2007-12-01,2,2,1,1,3,3,6
AIQUILE,desnutricion aguda,desnutricion grave (g),2007-12-01,1,2,2,0,3,2,5
ALALAY,desnutricion aguda,desnutricion grave (g),2007-12-01,1,1,0,0,1,1,2
ANTEQUERA,desnutricion aguda,desnutricion grave (g),2007-12-01,0,0,0,3,0,3,3
ARAMPAMPA,desnutricion aguda,desnutricion grave (g),2007-12-01,2,3,1,1,3,4,7
ARBIETO,desnutricion aguda,desnutricion grave (g),2007-12-01,0,1,0,1,0,2,2
ARQUE,desnutricion aguda,desnutricion grave (g),2007-12-01,1,1,0,0,1,1,2
ASCENCION DE GUARAYOS,desnutricion aguda,desnutricion grave (g),2007-12-01,5,2,3,2,8,4,12
ATOCHA,desnutricion aguda,desnutricion grave (g),2007-12-01,0,1,0,0,0,1,1
AYOPAYA (V. DE INDEPENDENCIA),desnutricion aguda,desnutricion grave (g),2007-12-01,0,0,2,0,2,0,2
AZURDUY,desnutricion aguda,desnutricion grave (g),2007-12-01,3,2,1,3,4,5,9
BERMEJO,desnutricion aguda,desnutricion grave (g),2007-12-01,1,0,0,0,1,0,1
BETANZOS,desnutricion aguda,desnutricion grave (g),2007-12-01,7,3,2,3,9,6,15
BOLIVAR,desnutricion aguda,desnutricion grave (g),2007-12-01,1,0,0,1,1,1,2
CABEZAS,desnutricion aguda,desnutricion grave (g),2007-12-01,0,1,0,0,0,1,1
"CAIZA ""D""",desnutricion aguda,desnutricion grave (g),2007-12-01,1,0,0,0,1,0,1
CAMARGO,desnutricion aguda,desnutricion grave (g),2007-12-01,0,3,0,2,0,5,5
CAMIRI,desnutricion aguda,desnutricion grave (g),2007-12-01,0,1,0,0,0,1,1
CAPINOTA,desnutricion aguda,desnutricion grave (g),2007-12-01,2,1,0,0,2,1,3
CARACOLLO,desnutricion aguda,desnutricion grave (g),2007-12-01,2,0,1,0,3,0,3
CARIPUYO,desnutricion aguda,desnutricion grave (g),2007-12-01,0,3,1,2,1,5,6
CHALLAPATA,desnutricion aguda,desnutricion grave (g),2007-12-01,0,0,1,0,1,0,1
CHAQUI,desnutricion aguda,desnutricion grave (g),2007-12-01,1,0,0,0,1,0,1
CHARAGUA,desnutricion aguda,desnutricion grave (g),2007-12-01,0,2,0,1,0,3,3
CHAYANTA,desnutricion aguda,desnutricion grave (g),2007-12-01,1,1,0,1,1,2,3
CHIMORE,desnutricion aguda,desnutricion grave (g),2007-12-01,0,0,2,0,2,0,2
CLIZA,desnutricion aguda,desnutricion grave (g),2007-12-01,1,0,0,0,1,0,1
COBIJA,desnutricion aguda,desnutricion grave (g),2007-12-01,4,2,0,0,4,2,6
COCHABAMBA,desnutricion aguda,desnutricion grave (g),2007-12-01,11,15,4,5,15,20,35
COLCAPIRHUA,desnutricion aguda,desnutricion grave (g),2007-12-01,2,0,0,0,2,0,2
COLQUECHACA,desnutricion aguda,desnutricion grave (g),2007-12-01,6,7,1,1,7,8,15
COLQUIRI,desnutricion aguda,desnutricion grave (g),2007-12-01,1,1,0,0,1,1,2
COMARAPA,desnutricion aguda,desnutricion grave (g),2007-12-01,0,2,0,0,0,2,2
CONCEPCION,desnutricion aguda,desnutricion grave (g),2007-12-01,2,4,0,0,2,4,6
COTAGAITA,desnutricion aguda,desnutricion grave (g),2007-12-01,1,5,2,1,3,6,9
COTOCA,desnutricion aguda,desnutricion grave (g),2007-12-01,2,1,0,0,2,1,3
CUEVO,desnutricion aguda,desnutricion grave (g),2007-12-01,0,0,1,0,1,0,1
CULPINA,desnutricion aguda,desnutricion grave (g),2007-12-01,0,2,0,0,0,2,2
EL PUENTE(STC),desnutricion aguda,desnutricion grave (g),2007-12-01,0,0,1,0,1,0,1
EL TORNO,desnutricion aguda,desnutricion grave (g),2007-12-01,1,1,0,0,1,1,2
EL VILLAR,desnutricion aguda,desnutricion grave (g),2007-12-01,0,1,0,1,0,2,2
ENTRE RIOS,desnutricion aguda,desnutricion grave (g),2007-12-01,0,0,0,1,0,1,1
ENTRE RIOS,desnutricion aguda,desnutricion grave (g),2007-12-01,0,0,0,1,0,1,1
GENERAL SAAVEDRA,desnutricion aguda,desnutricion grave (g),2007-12-01,0,0,1,0,1,0,1
GUAYARAMERIN,desnutricion aguda,desnutricion grave (g),2007-12-01,4,1,0,1,4,2,6
GUTIERREZ,desnutricion aguda,desnutricion grave (g),2007-12-01,2,4,2,2,4,6,10
HUANUNI,desnutricion aguda,desnutricion grave (g),2007-12-01,1,0,0,0,1,0,1
HUARACAJE,desnutricion aguda,desnutricion grave (g),2007-12-01,0,1,0,0,0,1,1
ICLA,desnutricion aguda,desnutricion grave (g),2007-12-01,4,13,0,1,4,14,18
INCAHUASI,desnutricion aguda,desnutricion grave (g),2007-12-01,4,2,0,2,4,4,8
INQUISIVI,desnutricion aguda,desnutricion grave (g),2007-12-01,2,0,0,0,2,0,2
LA GUARDIA,desnutricion aguda,desnutricion grave (g),2007-12-01,5,8,0,0,5,8,13
LLALLAGUA,desnutricion aguda,desnutricion grave (g),2007-12-01,1,1,0,0,1,1,2
MINEROS,desnutricion aguda,desnutricion grave (g),2007-12-01,2,0,0,0,2,0,2
MIZQUE,desnutricion aguda,desnutricion grave (g),2007-12-01,0,3,0,0,0,3,3
MOJOCOYA,desnutricion aguda,desnutricion grave (g),2007-12-01,0,0,0,1,0,1,1
MONTEAGUDO,desnutricion aguda,desnutricion grave (g),2007-12-01,2,2,2,2,4,4,8
MONTERO,desnutricion aguda,desnutricion grave (g),2007-12-01,5,2,0,0,5,2,7
MOROCHATA,desnutricion aguda,desnutricion grave (g),2007-12-01,1,1,0,0,1,1,2
OCURI,desnutricion aguda,desnutricion grave (g),2007-12-01,6,6,3,1,9,7,16
ORURO,desnutricion aguda,desnutricion grave (g),2007-12-01,1,1,0,0,1,1,2
PADCAYA,desnutricion aguda,desnutricion grave (g),2007-12-01,0,0,0,1,0,1,1
PADILLA,desnutricion aguda,desnutricion grave (g),2007-12-01,2,1,0,0,2,1,3
PAILON,desnutricion aguda,desnutricion grave (g),2007-12-01,1,0,0,0,1,0,1
PAMPA GRANDE,desnutricion aguda,desnutricion grave (g),2007-12-01,0,1,0,0,0,1,1
POCOATA,desnutricion aguda,desnutricion grave (g),2007-12-01,1,4,2,1,3,5,8
POCONA,desnutricion aguda,desnutricion grave (g),2007-12-01,1,1,0,0,1,1,2
PORCO,desnutricion aguda,desnutricion grave (g),2007-12-01,0,3,0,0,0,3,3
POROMA,desnutricion aguda,desnutricion grave (g),2007-12-01,1,8,1,4,2,12,14
PORTACHUELO,desnutricion aguda,desnutricion grave (g),2007-12-01,0,0,1,0,1,0,1
PORVENIR,desnutricion aguda,desnutricion grave (g),2007-12-01,0,1,0,0,0,1,1
PRESTO,desnutricion aguda,desnutricion grave (g),2007-12-01,1,0,1,0,2,0,2
PUCARA,desnutricion aguda,desnutricion grave (g),2007-12-01,1,0,0,0,1,0,1
PUERTO GONZALO MORENO,desnutricion aguda,desnutricion grave (g),2007-12-01,1,2,1,0,2,2,4
PUERTO VILLARROEL,desnutricion aguda,desnutricion grave (g),2007-12-01,6,4,4,2,10,6,16
PUNA,desnutricion aguda,desnutricion grave (g),2007-12-01,10,3,3,4,13,7,20
QUILLACOLLO,desnutricion aguda,desnutricion grave (g),2007-12-01,4,4,2,3,6,7,13
RAVELO,desnutricion aguda,desnutricion grave (g),2007-12-01,5,7,2,0,7,7,14
RIBERALTA,desnutricion aguda,desnutricion grave (g),2007-12-01,13,27,0,4,13,31,44
ROBORE,desnutricion aguda,desnutricion grave (g),2007-12-01,2,0,0,1,2,1,3
RURRENABAQUE,desnutricion aguda,desnutricion grave (g),2007-12-01,0,2,0,0,0,2,2
SACABA,desnutricion aguda,desnutricion grave (g),2007-12-01,1,2,1,0,2,2,4
SACACA,desnutricion aguda,desnutricion grave (g),2007-12-01,7,1,1,3,8,4,12
SAIPINA,desnutricion aguda,desnutricion grave (g),2007-12-01,0,0,2,0,2,0,2
SAN ANTONIO DE LOMERIO,desnutricion aguda,desnutricion grave (g),2007-12-01,2,1,1,0,3,1,4
SAN BORJA,desnutricion aguda,desnutricion grave (g),2007-12-01,5,1,2,0,7,1,8
SAN CARLOS,desnutricion aguda,desnutricion grave (g),2007-12-01,2,0,0,1,2,1,3
SAN IGNACIO,desnutricion aguda,desnutricion grave (g),2007-12-01,1,4,0,0,1,4,5
SAN IGNACIO DE VELASCO,desnutricion aguda,desnutricion grave (g),2007-12-01,2,3,2,1,4,4,8
SAN JOSE DE CHIQUITOS,desnutricion aguda,desnutricion grave (g),2007-12-01,1,0,0,0,1,0,1
SAN JUAN DE YAPACANI,desnutricion aguda,desnutricion grave (g),2007-12-01,1,1,0,0,1,1,2
SAN LORENZO(PND),desnutricion aguda,desnutricion grave (g),2007-12-01,0,1,0,0,0,1,1
SAN LUCAS,desnutricion aguda,desnutricion grave (g),2007-12-01,10,4,1,2,11,6,17
SAN MATIAS,desnutricion aguda,desnutricion grave (g),2007-12-01,1,0,0,0,1,0,1
SAN PEDRO,desnutricion aguda,desnutricion grave (g),2007-12-01,0,1,0,0,0,1,1
SAN PEDRO DE BUENA VISTA,desnutricion aguda,desnutricion grave (g),2007-12-01,1,2,0,2,1,4,5
SAN RAFAEL,desnutricion aguda,desnutricion grave (g),2007-12-01,0,0,0,1,0,1,1
SAN RAMON,desnutricion aguda,desnutricion grave (g),2007-12-01,0,0,1,0,1,0,1
SANTA ANA,desnutricion aguda,desnutricion grave (g),2007-12-01,0,3,0,0,0,3,3
SANTA CRUZ DE LA SIERRA,desnutricion aguda,desnutricion grave (g),2007-12-01,6,12,4,2,10,14,24
SANTA ROSA DEL SARA,desnutricion aguda,desnutricion grave (g),2007-12-01,1,0,0,1,1,1,2
SANTIAGO DE HUARI,desnutricion aguda,desnutricion grave (g),2007-12-01,1,2,0,0,1,2,3
SIPE SIPE,desnutricion aguda,desnutricion grave (g),2007-12-01,4,3,2,3,6,6,12
SOPACHUY,desnutricion aguda,desnutricion grave (g),2007-12-01,1,2,0,0,1,2,3
SORACACHI,desnutricion aguda,desnutricion grave (g),2007-12-01,1,0,0,0,1,0,1
SUCRE,desnutricion aguda,desnutricion grave (g),2007-12-01,11,1,1,3,12,4,16
TACOBAMBA,desnutricion aguda,desnutricion grave (g),2007-12-01,4,1,0,1,4,2,6
TACOPAYA,desnutricion aguda,desnutricion grave (g),2007-12-01,1,0,0,0,1,0,1
TAPACARI,desnutricion aguda,desnutricion grave (g),2007-12-01,3,3,1,2,4,5,9
TARABUCO,desnutricion aguda,desnutricion grave (g),2007-12-01,12,5,1,3,13,8,21
TARIJA,desnutricion aguda,desnutricion grave (g),2007-12-01,1,7,1,1,2,8,10
TARVITA,desnutricion aguda,desnutricion grave (g),2007-12-01,0,2,0,2,0,4,4
TINGUIPAYA,desnutricion aguda,desnutricion grave (g),2007-12-01,2,2,3,1,5,3,8
TIRAQUE (CBBA),desnutricion aguda,desnutricion grave (g),2007-12-01,0,2,3,2,3,4,7
TOCO,desnutricion aguda,desnutricion grave (g),2007-12-01,0,1,0,0,0,1,1
TOLEDO,desnutricion aguda,desnutricion grave (g),2007-12-01,0,1,0,0,0,1,1
TOMAVE,desnutricion aguda,desnutricion grave (g),2007-12-01,0,1,1,2,1,3,4
TOMINA,desnutricion aguda,desnutricion grave (g),2007-12-01,2,3,3,5,5,8,13
TORO TORO,desnutricion aguda,desnutricion grave (g),2007-12-01,2,4,0,0,2,4,6
TOTORA(CBBA),desnutricion aguda,desnutricion grave (g),2007-12-01,0,1,1,0,1,1,2
TOTORA(ORR),desnutricion aguda,desnutricion grave (g),2007-12-01,1,1,0,0,1,1,2
TRINIDAD,desnutricion aguda,desnutricion grave (g),2007-12-01,3,3,1,1,4,4,8
TUPIZA,desnutricion aguda,desnutricion grave (g),2007-12-01,3,0,1,0,4,0,4
UNCIA,desnutricion aguda,desnutricion grave (g),2007-12-01,1,3,1,0,2,3,5
URIONDO (A. CONCEPCION),desnutricion aguda,desnutricion grave (g),2007-12-01,1,0,0,0,1,0,1
URUBICHA,desnutricion aguda,desnutricion grave (g),2007-12-01,1,6,3,3,4,9,13
VACAS,desnutricion aguda,desnutricion grave (g),2007-12-01,1,0,0,1,1,1,2
VALLEGRANDE,desnutricion aguda,desnutricion grave (g),2007-12-01,0,1,0,0,0,1,1
VILLA MONTES,desnutricion aguda,desnutricion grave (g),2007-12-01,0,1,1,0,1,1,2
VILLA NUEVA (LOMA ALTA),desnutricion aguda,desnutricion grave (g),2007-12-01,1,1,0,0,1,1,2
VILLA SERRANO,desnutricion aguda,desnutricion grave (g),2007-12-01,0,0,1,1,1,1,2
VILLA TUNARI,desnutricion aguda,desnutricion grave (g),2007-12-01,0,5,0,0,0,5,5
VILLAZON,desnutricion aguda,desnutricion grave (g),2007-12-01,1,3,1,0,2,3,5
VITICHI,desnutricion aguda,desnutricion grave (g),2007-12-01,3,3,0,0,3,3,6
WARNES,desnutricion aguda,desnutricion grave (g),2007-12-01,2,2,0,2,2,4,6
YACUIBA,desnutricion aguda,desnutricion grave (g),2007-12-01,0,2,2,1,2,3,5
YAMPARAEZ,desnutricion aguda,desnutricion grave (g),2007-12-01,2,0,2,0,4,0,4
YAPACANI,desnutricion aguda,desnutricion grave (g),2007-12-01,2,3,0,0,2,3,5
YUNCHARA,desnutricion aguda,desnutricion grave (g),2007-12-01,1,0,0,0,1,0,1
ZUDAÑEZ,desnutricion aguda,desnutricion grave (g),2007-12-01,0,0,1,1,1,1,2
