municipality,group,variable,month,Dentro-H,Dentro-M,Fuera-H,Fuera-M,TOTAL-H,TOTAL-M,TOTAL
ACACIO,mortalidad institucional,otras muertes en personas mayores de 5 anos,2005-01-01,0,0,1,0,1,0,1
APOLO,mortalidad institucional,otras muertes en personas mayores de 5 anos,2005-01-01,1,0,0,0,1,0,1
ARAMPAMPA,mortalidad institucional,otras muertes en personas mayores de 5 anos,2005-01-01,0,0,1,0,1,0,1
ATOCHA,mortalidad institucional,otras muertes en personas mayores de 5 anos,2005-01-01,1,0,0,0,1,0,1
AZURDUY,mortalidad institucional,otras muertes en personas mayores de 5 anos,2005-01-01,0,0,1,0,1,0,1
BELEN DE ANDAMARCA,mortalidad institucional,otras muertes en personas mayores de 5 anos,2005-01-01,0,0,1,1,1,1,2
BERMEJO,mortalidad institucional,otras muertes en personas mayores de 5 anos,2005-01-01,1,0,0,0,1,0,1
BETANZOS,mortalidad institucional,otras muertes en personas mayores de 5 anos,2005-01-01,0,0,1,1,1,1,2
BUENA VISTA,mortalidad institucional,otras muertes en personas mayores de 5 anos,2005-01-01,1,0,0,1,1,1,2
CAMARGO,mortalidad institucional,otras muertes en personas mayores de 5 anos,2005-01-01,1,0,0,0,1,0,1
CAMIRI,mortalidad institucional,otras muertes en personas mayores de 5 anos,2005-01-01,3,4,0,0,3,4,7
CHAQUI,mortalidad institucional,otras muertes en personas mayores de 5 anos,2005-01-01,0,0,0,1,0,1,1
CHARAGUA,mortalidad institucional,otras muertes en personas mayores de 5 anos,2005-01-01,1,0,0,0,1,0,1
CHARAÃ‘A,mortalidad institucional,otras muertes en personas mayores de 5 anos,2005-01-01,0,0,0,1,0,1,1
CHULUMANI (V. DE LA LIBERTAD),mortalidad institucional,otras muertes en personas mayores de 5 anos,2005-01-01,3,0,0,0,3,0,3
COBIJA,mortalidad institucional,otras muertes en personas mayores de 5 anos,2005-01-01,3,0,0,0,3,0,3
COCHABAMBA,mortalidad institucional,otras muertes en personas mayores de 5 anos,2005-01-01,53,27,0,1,53,28,81
COLCAPIRHUA,mortalidad institucional,otras muertes en personas mayores de 5 anos,2005-01-01,1,0,0,0,1,0,1
COLOMI,mortalidad institucional,otras muertes en personas mayores de 5 anos,2005-01-01,1,0,4,3,5,3,8
COLQUENCHA,mortalidad institucional,otras muertes en personas mayores de 5 anos,2005-01-01,0,0,0,1,0,1,1
COROICO,mortalidad institucional,otras muertes en personas mayores de 5 anos,2005-01-01,1,1,0,1,1,2,3
COTAGAITA,mortalidad institucional,otras muertes en personas mayores de 5 anos,2005-01-01,0,0,0,1,0,1,1
EL ALTO,mortalidad institucional,otras muertes en personas mayores de 5 anos,2005-01-01,5,7,2,2,7,9,16
EUREKA (SANTOS MERCADO),mortalidad institucional,otras muertes en personas mayores de 5 anos,2005-01-01,0,1,0,0,0,1,1
FERNANDEZ ALONSO,mortalidad institucional,otras muertes en personas mayores de 5 anos,2005-01-01,0,0,1,0,1,0,1
GUAYARAMERIN,mortalidad institucional,otras muertes en personas mayores de 5 anos,2005-01-01,3,1,0,0,3,1,4
HUACAYA (VILLA DE HUACAYA),mortalidad institucional,otras muertes en personas mayores de 5 anos,2005-01-01,0,0,0,1,0,1,1
HUAYLLAMARCA,mortalidad institucional,otras muertes en personas mayores de 5 anos,2005-01-01,1,0,0,0,1,0,1
ICLA,mortalidad institucional,otras muertes en personas mayores de 5 anos,2005-01-01,0,0,1,0,1,0,1
LA PAZ,mortalidad institucional,otras muertes en personas mayores de 5 anos,2005-01-01,111,47,3,3,114,50,164
LLALLAGUA,mortalidad institucional,otras muertes en personas mayores de 5 anos,2005-01-01,2,1,0,0,2,1,3
MACHARETI,mortalidad institucional,otras muertes en personas mayores de 5 anos,2005-01-01,0,0,1,2,1,2,3
MAIRANA,mortalidad institucional,otras muertes en personas mayores de 5 anos,2005-01-01,0,1,0,0,0,1,1
MAPIRI,mortalidad institucional,otras muertes en personas mayores de 5 anos,2005-01-01,1,0,0,0,1,0,1
MOCOMOCO,mortalidad institucional,otras muertes en personas mayores de 5 anos,2005-01-01,0,0,1,0,1,0,1
MOJOCOYA,mortalidad institucional,otras muertes en personas mayores de 5 anos,2005-01-01,0,0,1,0,1,0,1
MONTEAGUDO,mortalidad institucional,otras muertes en personas mayores de 5 anos,2005-01-01,1,2,5,2,6,4,10
MONTERO,mortalidad institucional,otras muertes en personas mayores de 5 anos,2005-01-01,0,0,7,0,7,0,7
OCURI,mortalidad institucional,otras muertes en personas mayores de 5 anos,2005-01-01,0,1,0,0,0,1,1
ORURO,mortalidad institucional,otras muertes en personas mayores de 5 anos,2005-01-01,17,15,0,3,17,18,35
PADILLA,mortalidad institucional,otras muertes en personas mayores de 5 anos,2005-01-01,0,0,0,1,0,1,1
PALOS BLANCOS,mortalidad institucional,otras muertes en personas mayores de 5 anos,2005-01-01,0,0,0,1,0,1,1
POROMA,mortalidad institucional,otras muertes en personas mayores de 5 anos,2005-01-01,0,0,1,0,1,0,1
PORTACHUELO,mortalidad institucional,otras muertes en personas mayores de 5 anos,2005-01-01,0,1,0,0,0,1,1
POTOSI,mortalidad institucional,otras muertes en personas mayores de 5 anos,2005-01-01,13,17,0,0,13,17,30
PRESTO,mortalidad institucional,otras muertes en personas mayores de 5 anos,2005-01-01,0,0,4,4,4,4,8
PUERTO ACOSTA,mortalidad institucional,otras muertes en personas mayores de 5 anos,2005-01-01,0,0,2,0,2,0,2
PUERTO RICO,mortalidad institucional,otras muertes en personas mayores de 5 anos,2005-01-01,2,0,0,0,2,0,2
PUERTO SUAREZ,mortalidad institucional,otras muertes en personas mayores de 5 anos,2005-01-01,1,0,0,0,1,0,1
PUERTO VILLARROEL,mortalidad institucional,otras muertes en personas mayores de 5 anos,2005-01-01,1,0,0,0,1,0,1
PUNA,mortalidad institucional,otras muertes en personas mayores de 5 anos,2005-01-01,0,0,4,0,4,0,4
PUNATA,mortalidad institucional,otras muertes en personas mayores de 5 anos,2005-01-01,1,1,4,5,5,6,11
QUILLACOLLO,mortalidad institucional,otras muertes en personas mayores de 5 anos,2005-01-01,2,1,0,0,2,1,3
QUIME,mortalidad institucional,otras muertes en personas mayores de 5 anos,2005-01-01,1,0,0,0,1,0,1
RAVELO,mortalidad institucional,otras muertes en personas mayores de 5 anos,2005-01-01,0,0,0,2,0,2,2
REYES,mortalidad institucional,otras muertes en personas mayores de 5 anos,2005-01-01,0,1,0,0,0,1,1
RIBERALTA,mortalidad institucional,otras muertes en personas mayores de 5 anos,2005-01-01,1,0,0,0,1,0,1
RURRENABAQUE,mortalidad institucional,otras muertes en personas mayores de 5 anos,2005-01-01,1,1,0,0,1,1,2
SACABA,mortalidad institucional,otras muertes en personas mayores de 5 anos,2005-01-01,0,1,1,3,1,4,5
SAIPINA,mortalidad institucional,otras muertes en personas mayores de 5 anos,2005-01-01,1,0,0,0,1,0,1
SAN BORJA,mortalidad institucional,otras muertes en personas mayores de 5 anos,2005-01-01,1,0,0,0,1,0,1
SAN CARLOS,mortalidad institucional,otras muertes en personas mayores de 5 anos,2005-01-01,1,0,0,0,1,0,1
SAN IGNACIO DE VELASCO,mortalidad institucional,otras muertes en personas mayores de 5 anos,2005-01-01,3,0,0,1,3,1,4
SAN JOSE DE CHIQUITOS,mortalidad institucional,otras muertes en personas mayores de 5 anos,2005-01-01,1,0,0,0,1,0,1
SAN JUAN DE YAPACANI,mortalidad institucional,otras muertes en personas mayores de 5 anos,2005-01-01,1,1,0,0,1,1,2
SAN LUCAS,mortalidad institucional,otras muertes en personas mayores de 5 anos,2005-01-01,0,0,3,0,3,0,3
SAN PEDRO,mortalidad institucional,otras muertes en personas mayores de 5 anos,2005-01-01,1,0,1,0,2,0,2
SANTA CRUZ DE LA SIERRA,mortalidad institucional,otras muertes en personas mayores de 5 anos,2005-01-01,5,8,1,0,6,8,14
SANTIAGO DE HUARI,mortalidad institucional,otras muertes en personas mayores de 5 anos,2005-01-01,0,0,0,2,0,2,2
SORACACHI,mortalidad institucional,otras muertes en personas mayores de 5 anos,2005-01-01,0,0,2,0,2,0,2
SORATA,mortalidad institucional,otras muertes en personas mayores de 5 anos,2005-01-01,1,1,0,0,1,1,2
SUCRE,mortalidad institucional,otras muertes en personas mayores de 5 anos,2005-01-01,18,12,0,0,18,12,30
TARABUCO,mortalidad institucional,otras muertes en personas mayores de 5 anos,2005-01-01,0,0,1,2,1,2,3
TARIJA,mortalidad institucional,otras muertes en personas mayores de 5 anos,2005-01-01,18,14,0,0,18,14,32
TARVITA,mortalidad institucional,otras muertes en personas mayores de 5 anos,2005-01-01,0,0,0,1,0,1,1
TOLEDO,mortalidad institucional,otras muertes en personas mayores de 5 anos,2005-01-01,1,0,1,0,2,0,2
TOMINA,mortalidad institucional,otras muertes en personas mayores de 5 anos,2005-01-01,0,1,0,6,0,7,7
TORO TORO,mortalidad institucional,otras muertes en personas mayores de 5 anos,2005-01-01,0,0,1,3,1,3,4
TOTORA(CBBA),mortalidad institucional,otras muertes en personas mayores de 5 anos,2005-01-01,1,0,0,0,1,0,1
TRINIDAD,mortalidad institucional,otras muertes en personas mayores de 5 anos,2005-01-01,9,3,3,4,12,7,19
TUPIZA,mortalidad institucional,otras muertes en personas mayores de 5 anos,2005-01-01,0,1,3,6,3,7,10
UYUNI,mortalidad institucional,otras muertes en personas mayores de 5 anos,2005-01-01,1,0,1,3,2,3,5
VALLEGRANDE,mortalidad institucional,otras muertes en personas mayores de 5 anos,2005-01-01,0,0,1,1,1,1,2
VILLA SERRANO,mortalidad institucional,otras muertes en personas mayores de 5 anos,2005-01-01,0,0,3,0,3,0,3
VILLA TUNARI,mortalidad institucional,otras muertes en personas mayores de 5 anos,2005-01-01,3,0,0,0,3,0,3
VILLA VACA GUZMAN (MUYUPAMPA),mortalidad institucional,otras muertes en personas mayores de 5 anos,2005-01-01,0,0,1,1,1,1,2
VILLAZON,mortalidad institucional,otras muertes en personas mayores de 5 anos,2005-01-01,0,2,0,0,0,2,2
WARNES,mortalidad institucional,otras muertes en personas mayores de 5 anos,2005-01-01,0,0,0,1,0,1,1
YACUIBA,mortalidad institucional,otras muertes en personas mayores de 5 anos,2005-01-01,4,3,0,0,4,3,7
YAMPARAEZ,mortalidad institucional,otras muertes en personas mayores de 5 anos,2005-01-01,1,0,3,2,4,2,6
YAPACANI,mortalidad institucional,otras muertes en personas mayores de 5 anos,2005-01-01,1,0,0,3,1,3,4
YOTALA,mortalidad institucional,otras muertes en personas mayores de 5 anos,2005-01-01,0,1,2,2,2,3,5
ACACIO,mortalidad institucional,otras muertes en personas mayores de 5 anos,2005-02-01,0,0,0,1,0,1,1
ACHACACHI,mortalidad institucional,otras muertes en personas mayores de 5 anos,2005-02-01,1,0,0,0,1,0,1
ARAMPAMPA,mortalidad institucional,otras muertes en personas mayores de 5 anos,2005-02-01,0,0,1,1,1,1,2
AYOPAYA (V. DE INDEPENDENCIA),mortalidad institucional,otras muertes en personas mayores de 5 anos,2005-02-01,1,0,0,0,1,0,1
BERMEJO,mortalidad institucional,otras muertes en personas mayores de 5 anos,2005-02-01,0,2,0,0,0,2,2
BETANZOS,mortalidad institucional,otras muertes en personas mayores de 5 anos,2005-02-01,0,0,1,2,1,2,3
BUENA VISTA,mortalidad institucional,otras muertes en personas mayores de 5 anos,2005-02-01,1,0,0,0,1,0,1
"CAIZA ""D""",mortalidad institucional,otras muertes en personas mayores de 5 anos,2005-02-01,0,0,1,2,1,2,3
CAMARGO,mortalidad institucional,otras muertes en personas mayores de 5 anos,2005-02-01,0,0,0,1,0,1,1
CAMIRI,mortalidad institucional,otras muertes en personas mayores de 5 anos,2005-02-01,1,1,0,0,1,1,2
CARANAVI,mortalidad institucional,otras muertes en personas mayores de 5 anos,2005-02-01,1,0,1,4,2,4,6
CHALLAPATA,mortalidad institucional,otras muertes en personas mayores de 5 anos,2005-02-01,1,0,0,0,1,0,1
CHAQUI,mortalidad institucional,otras muertes en personas mayores de 5 anos,2005-02-01,0,0,2,1,2,1,3
CHARAGUA,mortalidad institucional,otras muertes en personas mayores de 5 anos,2005-02-01,0,1,0,0,0,1,1
CHULUMANI (V. DE LA LIBERTAD),mortalidad institucional,otras muertes en personas mayores de 5 anos,2005-02-01,2,0,0,0,2,0,2
COBIJA,mortalidad institucional,otras muertes en personas mayores de 5 anos,2005-02-01,2,2,1,2,3,4,7
COCHABAMBA,mortalidad institucional,otras muertes en personas mayores de 5 anos,2005-02-01,44,31,0,3,44,34,78
COLCAPIRHUA,mortalidad institucional,otras muertes en personas mayores de 5 anos,2005-02-01,1,0,0,0,1,0,1
"COLCHA ""K""",mortalidad institucional,otras muertes en personas mayores de 5 anos,2005-02-01,0,0,0,1,0,1,1
COLOMI,mortalidad institucional,otras muertes en personas mayores de 5 anos,2005-02-01,0,0,0,1,0,1,1
COMARAPA,mortalidad institucional,otras muertes en personas mayores de 5 anos,2005-02-01,1,1,0,0,1,1,2
COROICO,mortalidad institucional,otras muertes en personas mayores de 5 anos,2005-02-01,1,0,0,1,1,1,2
COTAGAITA,mortalidad institucional,otras muertes en personas mayores de 5 anos,2005-02-01,0,0,1,0,1,0,1
COTOCA,mortalidad institucional,otras muertes en personas mayores de 5 anos,2005-02-01,0,1,0,0,0,1,1
EL ALTO,mortalidad institucional,otras muertes en personas mayores de 5 anos,2005-02-01,6,5,2,2,8,7,15
GUANAY,mortalidad institucional,otras muertes en personas mayores de 5 anos,2005-02-01,0,1,0,0,0,1,1
GUTIERREZ,mortalidad institucional,otras muertes en personas mayores de 5 anos,2005-02-01,1,0,0,0,1,0,1
ICLA,mortalidad institucional,otras muertes en personas mayores de 5 anos,2005-02-01,0,0,1,1,1,1,2
INCAHUASI,mortalidad institucional,otras muertes en personas mayores de 5 anos,2005-02-01,0,0,1,0,1,0,1
IRUPANA (VILLA DE LANZA),mortalidad institucional,otras muertes en personas mayores de 5 anos,2005-02-01,1,0,0,1,1,1,2
LA ASUNTA,mortalidad institucional,otras muertes en personas mayores de 5 anos,2005-02-01,1,0,0,0,1,0,1
LA PAZ,mortalidad institucional,otras muertes en personas mayores de 5 anos,2005-02-01,83,72,4,5,87,77,164
LLALLAGUA,mortalidad institucional,otras muertes en personas mayores de 5 anos,2005-02-01,0,2,3,3,3,5,8
MACHARETI,mortalidad institucional,otras muertes en personas mayores de 5 anos,2005-02-01,0,2,1,1,1,3,4
MAGDALENA,mortalidad institucional,otras muertes en personas mayores de 5 anos,2005-02-01,1,1,0,0,1,1,2
MIZQUE,mortalidad institucional,otras muertes en personas mayores de 5 anos,2005-02-01,0,1,2,0,2,1,3
MOCOMOCO,mortalidad institucional,otras muertes en personas mayores de 5 anos,2005-02-01,0,0,0,2,0,2,2
MONTEAGUDO,mortalidad institucional,otras muertes en personas mayores de 5 anos,2005-02-01,2,0,1,1,3,1,4
MONTERO,mortalidad institucional,otras muertes en personas mayores de 5 anos,2005-02-01,0,0,5,0,5,0,5
ORURO,mortalidad institucional,otras muertes en personas mayores de 5 anos,2005-02-01,18,19,4,3,22,22,44
POTOSI,mortalidad institucional,otras muertes en personas mayores de 5 anos,2005-02-01,9,5,1,1,10,6,16
PRESTO,mortalidad institucional,otras muertes en personas mayores de 5 anos,2005-02-01,0,0,0,1,0,1,1
PUCARA,mortalidad institucional,otras muertes en personas mayores de 5 anos,2005-02-01,0,1,0,0,0,1,1
PUERTO ACOSTA,mortalidad institucional,otras muertes en personas mayores de 5 anos,2005-02-01,0,0,0,2,0,2,2
PUERTO CARABUCO,mortalidad institucional,otras muertes en personas mayores de 5 anos,2005-02-01,0,0,1,1,1,1,2
PUERTO RICO,mortalidad institucional,otras muertes en personas mayores de 5 anos,2005-02-01,1,0,0,0,1,0,1
PUERTO VILLARROEL,mortalidad institucional,otras muertes en personas mayores de 5 anos,2005-02-01,4,0,0,0,4,0,4
PUNA,mortalidad institucional,otras muertes en personas mayores de 5 anos,2005-02-01,0,1,1,0,1,1,2
PUNATA,mortalidad institucional,otras muertes en personas mayores de 5 anos,2005-02-01,2,1,4,2,6,3,9
QUILLACOLLO,mortalidad institucional,otras muertes en personas mayores de 5 anos,2005-02-01,1,0,0,0,1,0,1
QUIME,mortalidad institucional,otras muertes en personas mayores de 5 anos,2005-02-01,1,0,0,0,1,0,1
RAVELO,mortalidad institucional,otras muertes en personas mayores de 5 anos,2005-02-01,0,0,0,1,0,1,1
REYES,mortalidad institucional,otras muertes en personas mayores de 5 anos,2005-02-01,0,1,0,0,0,1,1
RIBERALTA,mortalidad institucional,otras muertes en personas mayores de 5 anos,2005-02-01,2,0,0,0,2,0,2
RURRENABAQUE,mortalidad institucional,otras muertes en personas mayores de 5 anos,2005-02-01,1,0,0,0,1,0,1
SACABA,mortalidad institucional,otras muertes en personas mayores de 5 anos,2005-02-01,2,0,1,2,3,2,5
SACACA,mortalidad institucional,otras muertes en personas mayores de 5 anos,2005-02-01,0,0,3,0,3,0,3
SAN AGUSTIN,mortalidad institucional,otras muertes en personas mayores de 5 anos,2005-02-01,0,0,0,1,0,1,1
SAN ANDRES,mortalidad institucional,otras muertes en personas mayores de 5 anos,2005-02-01,2,0,0,0,2,0,2
SAN BORJA,mortalidad institucional,otras muertes en personas mayores de 5 anos,2005-02-01,1,1,0,0,1,1,2
SAN IGNACIO DE VELASCO,mortalidad institucional,otras muertes en personas mayores de 5 anos,2005-02-01,0,2,0,0,0,2,2
SAN LUCAS,mortalidad institucional,otras muertes en personas mayores de 5 anos,2005-02-01,0,0,5,5,5,5,10
SAN PEDRO,mortalidad institucional,otras muertes en personas mayores de 5 anos,2005-02-01,2,0,0,0,2,0,2
SAN PEDRO DE BUENA VISTA,mortalidad institucional,otras muertes en personas mayores de 5 anos,2005-02-01,0,0,4,0,4,0,4
SANTA ANA,mortalidad institucional,otras muertes en personas mayores de 5 anos,2005-02-01,0,1,0,1,0,2,2
SANTA CRUZ DE LA SIERRA,mortalidad institucional,otras muertes en personas mayores de 5 anos,2005-02-01,6,8,0,0,6,8,14
SUCRE,mortalidad institucional,otras muertes en personas mayores de 5 anos,2005-02-01,9,9,1,2,10,11,21
TARABUCO,mortalidad institucional,otras muertes en personas mayores de 5 anos,2005-02-01,1,0,2,3,3,3,6
TARIJA,mortalidad institucional,otras muertes en personas mayores de 5 anos,2005-02-01,19,14,2,2,21,16,37
TARVITA,mortalidad institucional,otras muertes en personas mayores de 5 anos,2005-02-01,0,0,2,0,2,0,2
TORO TORO,mortalidad institucional,otras muertes en personas mayores de 5 anos,2005-02-01,0,0,2,1,2,1,3
TRIGAL,mortalidad institucional,otras muertes en personas mayores de 5 anos,2005-02-01,1,0,0,0,1,0,1
TRINIDAD,mortalidad institucional,otras muertes en personas mayores de 5 anos,2005-02-01,4,3,1,0,5,3,8
TUPIZA,mortalidad institucional,otras muertes en personas mayores de 5 anos,2005-02-01,1,2,0,0,1,2,3
UMALA,mortalidad institucional,otras muertes en personas mayores de 5 anos,2005-02-01,0,0,1,0,1,0,1
UYUNI,mortalidad institucional,otras muertes en personas mayores de 5 anos,2005-02-01,0,0,1,9,1,9,10
VALLEGRANDE,mortalidad institucional,otras muertes en personas mayores de 5 anos,2005-02-01,2,1,0,0,2,1,3
VILLA MONTES,mortalidad institucional,otras muertes en personas mayores de 5 anos,2005-02-01,4,1,0,0,4,1,5
VILLA TUNARI,mortalidad institucional,otras muertes en personas mayores de 5 anos,2005-02-01,2,2,0,0,2,2,4
VILLA VACA GUZMAN (MUYUPAMPA),mortalidad institucional,otras muertes en personas mayores de 5 anos,2005-02-01,1,0,0,0,1,0,1
VILLAZON,mortalidad institucional,otras muertes en personas mayores de 5 anos,2005-02-01,3,2,0,0,3,2,5
YACUIBA,mortalidad institucional,otras muertes en personas mayores de 5 anos,2005-02-01,3,3,0,0,3,3,6
YAMPARAEZ,mortalidad institucional,otras muertes en personas mayores de 5 anos,2005-02-01,0,0,0,1,0,1,1
YAPACANI,mortalidad institucional,otras muertes en personas mayores de 5 anos,2005-02-01,3,0,0,2,3,2,5
YOTALA,mortalidad institucional,otras muertes en personas mayores de 5 anos,2005-02-01,0,0,1,1,1,1,2
ZUDAÃ‘EZ,mortalidad institucional,otras muertes en personas mayores de 5 anos,2005-02-01,0,0,0,2,0,2,2
AIQUILE,mortalidad institucional,otras muertes en personas mayores de 5 anos,2005-03-01,1,0,0,0,1,0,1
ATOCHA,mortalidad institucional,otras muertes en personas mayores de 5 anos,2005-03-01,1,0,0,0,1,0,1
AYATA,mortalidad institucional,otras muertes en personas mayores de 5 anos,2005-03-01,0,0,0,1,0,1,1
AZURDUY,mortalidad institucional,otras muertes en personas mayores de 5 anos,2005-03-01,0,0,1,1,1,1,2
BERMEJO,mortalidad institucional,otras muertes en personas mayores de 5 anos,2005-03-01,3,2,0,0,3,2,5
BETANZOS,mortalidad institucional,otras muertes en personas mayores de 5 anos,2005-03-01,0,0,0,3,0,3,3
BOYUIBE,mortalidad institucional,otras muertes en personas mayores de 5 anos,2005-03-01,1,0,0,0,1,0,1
BUENA VISTA,mortalidad institucional,otras muertes en personas mayores de 5 anos,2005-03-01,2,0,0,0,2,0,2
"CAIZA ""D""",mortalidad institucional,otras muertes en personas mayores de 5 anos,2005-03-01,1,0,0,2,1,2,3
CAMARGO,mortalidad institucional,otras muertes en personas mayores de 5 anos,2005-03-01,0,1,0,0,0,1,1
CAMIRI,mortalidad institucional,otras muertes en personas mayores de 5 anos,2005-03-01,3,1,0,0,3,1,4
CARANAVI,mortalidad institucional,otras muertes en personas mayores de 5 anos,2005-03-01,2,0,1,1,3,1,4
CHAQUI,mortalidad institucional,otras muertes en personas mayores de 5 anos,2005-03-01,0,0,2,1,2,1,3
CHARAGUA,mortalidad institucional,otras muertes en personas mayores de 5 anos,2005-03-01,0,2,0,0,0,2,2
COBIJA,mortalidad institucional,otras muertes en personas mayores de 5 anos,2005-03-01,2,2,0,0,2,2,4
COCHABAMBA,mortalidad institucional,otras muertes en personas mayores de 5 anos,2005-03-01,52,39,0,2,52,41,93
COLCAPIRHUA,mortalidad institucional,otras muertes en personas mayores de 5 anos,2005-03-01,3,0,0,0,3,0,3
COLOMI,mortalidad institucional,otras muertes en personas mayores de 5 anos,2005-03-01,0,0,5,4,5,4,9
COMARAPA,mortalidad institucional,otras muertes en personas mayores de 5 anos,2005-03-01,3,0,0,0,3,0,3
COROICO,mortalidad institucional,otras muertes en personas mayores de 5 anos,2005-03-01,1,0,0,1,1,1,2
CORQUE,mortalidad institucional,otras muertes en personas mayores de 5 anos,2005-03-01,0,0,2,0,2,0,2
COTOCA,mortalidad institucional,otras muertes en personas mayores de 5 anos,2005-03-01,0,0,3,0,3,0,3
CULPINA,mortalidad institucional,otras muertes en personas mayores de 5 anos,2005-03-01,0,0,0,1,0,1,1
EL ALTO,mortalidad institucional,otras muertes en personas mayores de 5 anos,2005-03-01,6,4,3,2,9,6,15
EUCALIPTUS,mortalidad institucional,otras muertes en personas mayores de 5 anos,2005-03-01,0,0,1,1,1,1,2
GUANAY,mortalidad institucional,otras muertes en personas mayores de 5 anos,2005-03-01,1,0,1,2,2,2,4
HUANUNI,mortalidad institucional,otras muertes en personas mayores de 5 anos,2005-03-01,0,0,1,0,1,0,1
HUAYLLAMARCA,mortalidad institucional,otras muertes en personas mayores de 5 anos,2005-03-01,0,0,0,1,0,1,1
ICLA,mortalidad institucional,otras muertes en personas mayores de 5 anos,2005-03-01,0,0,2,0,2,0,2
LA PAZ,mortalidad institucional,otras muertes en personas mayores de 5 anos,2005-03-01,91,87,7,10,98,97,195
LLALLAGUA,mortalidad institucional,otras muertes en personas mayores de 5 anos,2005-03-01,0,0,2,6,2,6,8
MACHARETI,mortalidad institucional,otras muertes en personas mayores de 5 anos,2005-03-01,0,0,2,0,2,0,2
MAGDALENA,mortalidad institucional,otras muertes en personas mayores de 5 anos,2005-03-01,1,0,0,0,1,0,1
MIZQUE,mortalidad institucional,otras muertes en personas mayores de 5 anos,2005-03-01,1,0,1,2,2,2,4
MOCOMOCO,mortalidad institucional,otras muertes en personas mayores de 5 anos,2005-03-01,0,0,0,2,0,2,2
MONTEAGUDO,mortalidad institucional,otras muertes en personas mayores de 5 anos,2005-03-01,4,0,0,5,4,5,9
MONTERO,mortalidad institucional,otras muertes en personas mayores de 5 anos,2005-03-01,2,0,9,0,11,0,11
ORURO,mortalidad institucional,otras muertes en personas mayores de 5 anos,2005-03-01,22,14,2,2,24,16,40
PADILLA,mortalidad institucional,otras muertes en personas mayores de 5 anos,2005-03-01,0,0,0,1,0,1,1
PALOS BLANCOS,mortalidad institucional,otras muertes en personas mayores de 5 anos,2005-03-01,0,0,1,0,1,0,1
PAPEL PAMPA,mortalidad institucional,otras muertes en personas mayores de 5 anos,2005-03-01,0,0,1,0,1,0,1
PORTACHUELO,mortalidad institucional,otras muertes en personas mayores de 5 anos,2005-03-01,0,1,0,0,0,1,1
POTOSI,mortalidad institucional,otras muertes en personas mayores de 5 anos,2005-03-01,11,6,0,0,11,6,17
PRESTO,mortalidad institucional,otras muertes en personas mayores de 5 anos,2005-03-01,0,0,0,1,0,1,1
PUERTO RICO,mortalidad institucional,otras muertes en personas mayores de 5 anos,2005-03-01,0,0,1,0,1,0,1
PUERTO VILLARROEL,mortalidad institucional,otras muertes en personas mayores de 5 anos,2005-03-01,1,0,0,0,1,0,1
PUNA,mortalidad institucional,otras muertes en personas mayores de 5 anos,2005-03-01,0,1,12,0,12,1,13
PUNATA,mortalidad institucional,otras muertes en personas mayores de 5 anos,2005-03-01,1,0,10,8,11,8,19
REYES,mortalidad institucional,otras muertes en personas mayores de 5 anos,2005-03-01,1,0,0,0,1,0,1
RIBERALTA,mortalidad institucional,otras muertes en personas mayores de 5 anos,2005-03-01,3,4,0,0,3,4,7
ROBORE,mortalidad institucional,otras muertes en personas mayores de 5 anos,2005-03-01,1,0,0,0,1,0,1
SACABA,mortalidad institucional,otras muertes en personas mayores de 5 anos,2005-03-01,1,0,5,8,6,8,14
SACACA,mortalidad institucional,otras muertes en personas mayores de 5 anos,2005-03-01,0,0,2,0,2,0,2
SALINAS DE GARCI MENDOZA,mortalidad institucional,otras muertes en personas mayores de 5 anos,2005-03-01,0,0,0,2,0,2,2
SAN ANDRES,mortalidad institucional,otras muertes en personas mayores de 5 anos,2005-03-01,0,1,0,0,0,1,1
SAN CARLOS,mortalidad institucional,otras muertes en personas mayores de 5 anos,2005-03-01,1,0,0,0,1,0,1
SAN IGNACIO DE VELASCO,mortalidad institucional,otras muertes en personas mayores de 5 anos,2005-03-01,2,0,0,0,2,0,2
SAN JAVIER(BNI),mortalidad institucional,otras muertes en personas mayores de 5 anos,2005-03-01,0,0,1,0,1,0,1
SAN JOAQUIN,mortalidad institucional,otras muertes en personas mayores de 5 anos,2005-03-01,0,1,0,0,0,1,1
SAN JOSE DE CHIQUITOS,mortalidad institucional,otras muertes en personas mayores de 5 anos,2005-03-01,0,0,5,1,5,1,6
SAN JULIAN,mortalidad institucional,otras muertes en personas mayores de 5 anos,2005-03-01,1,0,0,0,1,0,1
SAN LUCAS,mortalidad institucional,otras muertes en personas mayores de 5 anos,2005-03-01,0,0,2,3,2,3,5
SAN MATIAS,mortalidad institucional,otras muertes en personas mayores de 5 anos,2005-03-01,2,0,0,0,2,0,2
SAN MIGUEL DE VELASCO,mortalidad institucional,otras muertes en personas mayores de 5 anos,2005-03-01,0,0,1,1,1,1,2
SAN PEDRO,mortalidad institucional,otras muertes en personas mayores de 5 anos,2005-03-01,1,0,1,0,2,0,2
SANTA CRUZ DE LA SIERRA,mortalidad institucional,otras muertes en personas mayores de 5 anos,2005-03-01,1,1,0,0,1,1,2
SUCRE,mortalidad institucional,otras muertes en personas mayores de 5 anos,2005-03-01,10,19,0,0,10,19,29
TAPACARI,mortalidad institucional,otras muertes en personas mayores de 5 anos,2005-03-01,0,0,3,0,3,0,3
TARABUCO,mortalidad institucional,otras muertes en personas mayores de 5 anos,2005-03-01,0,0,8,4,8,4,12
TARIJA,mortalidad institucional,otras muertes en personas mayores de 5 anos,2005-03-01,21,13,3,2,24,15,39
TARVITA,mortalidad institucional,otras muertes en personas mayores de 5 anos,2005-03-01,0,0,2,0,2,0,2
TIPUANI,mortalidad institucional,otras muertes en personas mayores de 5 anos,2005-03-01,0,1,0,0,0,1,1
TIRAQUE (CBBA),mortalidad institucional,otras muertes en personas mayores de 5 anos,2005-03-01,1,0,0,0,1,0,1
TOMINA,mortalidad institucional,otras muertes en personas mayores de 5 anos,2005-03-01,0,1,2,0,2,1,3
TRINIDAD,mortalidad institucional,otras muertes en personas mayores de 5 anos,2005-03-01,13,8,3,2,16,10,26
TUPIZA,mortalidad institucional,otras muertes en personas mayores de 5 anos,2005-03-01,0,0,0,14,0,14,14
UMALA,mortalidad institucional,otras muertes en personas mayores de 5 anos,2005-03-01,0,0,0,1,0,1,1
UYUNI,mortalidad institucional,otras muertes en personas mayores de 5 anos,2005-03-01,0,0,4,3,4,3,7
VALLEGRANDE,mortalidad institucional,otras muertes en personas mayores de 5 anos,2005-03-01,0,0,0,1,0,1,1
VILLA MONTES,mortalidad institucional,otras muertes en personas mayores de 5 anos,2005-03-01,4,0,0,0,4,0,4
VILLA SERRANO,mortalidad institucional,otras muertes en personas mayores de 5 anos,2005-03-01,0,0,1,0,1,0,1
VILLA TUNARI,mortalidad institucional,otras muertes en personas mayores de 5 anos,2005-03-01,4,0,1,0,5,0,5
VILLA VACA GUZMAN (MUYUPAMPA),mortalidad institucional,otras muertes en personas mayores de 5 anos,2005-03-01,0,0,1,0,1,0,1
VILLAZON,mortalidad institucional,otras muertes en personas mayores de 5 anos,2005-03-01,2,1,0,0,2,1,3
VITICHI,mortalidad institucional,otras muertes en personas mayores de 5 anos,2005-03-01,0,0,2,0,2,0,2
YACUIBA,mortalidad institucional,otras muertes en personas mayores de 5 anos,2005-03-01,8,2,0,0,8,2,10
YAMPARAEZ,mortalidad institucional,otras muertes en personas mayores de 5 anos,2005-03-01,1,0,0,0,1,0,1
YAPACANI,mortalidad institucional,otras muertes en personas mayores de 5 anos,2005-03-01,1,0,0,0,1,0,1
YOTALA,mortalidad institucional,otras muertes en personas mayores de 5 anos,2005-03-01,0,0,1,0,1,0,1
ACHACACHI,mortalidad institucional,otras muertes en personas mayores de 5 anos,2005-04-01,0,1,2,2,2,3,5
AIQUILE,mortalidad institucional,otras muertes en personas mayores de 5 anos,2005-04-01,0,1,0,0,0,1,1
ALCALA,mortalidad institucional,otras muertes en personas mayores de 5 anos,2005-04-01,0,0,0,1,0,1,1
ANCORAIMES,mortalidad institucional,otras muertes en personas mayores de 5 anos,2005-04-01,0,0,1,1,1,1,2
ARAMPAMPA,mortalidad institucional,otras muertes en personas mayores de 5 anos,2005-04-01,0,0,0,1,0,1,1
AYOPAYA (V. DE INDEPENDENCIA),mortalidad institucional,otras muertes en personas mayores de 5 anos,2005-04-01,0,1,0,0,0,1,1
AZURDUY,mortalidad institucional,otras muertes en personas mayores de 5 anos,2005-04-01,0,0,0,1,0,1,1
BERMEJO,mortalidad institucional,otras muertes en personas mayores de 5 anos,2005-04-01,0,1,0,0,0,1,1
BETANZOS,mortalidad institucional,otras muertes en personas mayores de 5 anos,2005-04-01,0,0,6,4,6,4,10
BOLIVAR,mortalidad institucional,otras muertes en personas mayores de 5 anos,2005-04-01,0,0,0,1,0,1,1
"CAIZA ""D""",mortalidad institucional,otras muertes en personas mayores de 5 anos,2005-04-01,0,0,2,4,2,4,6
CAMARGO,mortalidad institucional,otras muertes en personas mayores de 5 anos,2005-04-01,1,0,0,0,1,0,1
CARANAVI,mortalidad institucional,otras muertes en personas mayores de 5 anos,2005-04-01,3,1,2,0,5,1,6
CHALLAPATA,mortalidad institucional,otras muertes en personas mayores de 5 anos,2005-04-01,0,0,1,3,1,3,4
CHAQUI,mortalidad institucional,otras muertes en personas mayores de 5 anos,2005-04-01,0,0,0,1,0,1,1
CHARAGUA,mortalidad institucional,otras muertes en personas mayores de 5 anos,2005-04-01,1,1,0,0,1,1,2
CHULUMANI (V. DE LA LIBERTAD),mortalidad institucional,otras muertes en personas mayores de 5 anos,2005-04-01,2,0,0,0,2,0,2
COBIJA,mortalidad institucional,otras muertes en personas mayores de 5 anos,2005-04-01,1,0,0,0,1,0,1
COCHABAMBA,mortalidad institucional,otras muertes en personas mayores de 5 anos,2005-04-01,37,18,0,1,37,19,56
COLLANA,mortalidad institucional,otras muertes en personas mayores de 5 anos,2005-04-01,0,0,0,1,0,1,1
COLOMI,mortalidad institucional,otras muertes en personas mayores de 5 anos,2005-04-01,0,0,3,1,3,1,4
COMARAPA,mortalidad institucional,otras muertes en personas mayores de 5 anos,2005-04-01,1,0,2,2,3,2,5
COPACABANA,mortalidad institucional,otras muertes en personas mayores de 5 anos,2005-04-01,0,0,0,2,0,2,2
CORIPATA,mortalidad institucional,otras muertes en personas mayores de 5 anos,2005-04-01,0,0,1,0,1,0,1
COROICO,mortalidad institucional,otras muertes en personas mayores de 5 anos,2005-04-01,0,1,0,3,0,4,4
CORQUE,mortalidad institucional,otras muertes en personas mayores de 5 anos,2005-04-01,0,0,0,1,0,1,1
COTOCA,mortalidad institucional,otras muertes en personas mayores de 5 anos,2005-04-01,0,0,2,0,2,0,2
CULPINA,mortalidad institucional,otras muertes en personas mayores de 5 anos,2005-04-01,0,0,2,2,2,2,4
EL ALTO,mortalidad institucional,otras muertes en personas mayores de 5 anos,2005-04-01,2,5,1,2,3,7,10
EL VILLAR,mortalidad institucional,otras muertes en personas mayores de 5 anos,2005-04-01,0,0,0,1,0,1,1
EUCALIPTUS,mortalidad institucional,otras muertes en personas mayores de 5 anos,2005-04-01,0,0,2,0,2,0,2
FERNANDEZ ALONSO,mortalidad institucional,otras muertes en personas mayores de 5 anos,2005-04-01,2,0,0,0,2,0,2
GUANAY,mortalidad institucional,otras muertes en personas mayores de 5 anos,2005-04-01,0,1,0,0,0,1,1
GUAYARAMERIN,mortalidad institucional,otras muertes en personas mayores de 5 anos,2005-04-01,0,1,0,0,0,1,1
GUTIERREZ,mortalidad institucional,otras muertes en personas mayores de 5 anos,2005-04-01,1,1,0,0,1,1,2
HUACARETA,mortalidad institucional,otras muertes en personas mayores de 5 anos,2005-04-01,1,0,2,0,3,0,3
HUACAYA (VILLA DE HUACAYA),mortalidad institucional,otras muertes en personas mayores de 5 anos,2005-04-01,0,0,1,1,1,1,2
HUANUNI,mortalidad institucional,otras muertes en personas mayores de 5 anos,2005-04-01,0,1,0,0,0,1,1
ICLA,mortalidad institucional,otras muertes en personas mayores de 5 anos,2005-04-01,1,0,0,1,1,1,2
INCAHUASI,mortalidad institucional,otras muertes en personas mayores de 5 anos,2005-04-01,0,0,1,0,1,0,1
LA PAZ,mortalidad institucional,otras muertes en personas mayores de 5 anos,2005-04-01,59,80,4,10,63,90,153
LLALLAGUA,mortalidad institucional,otras muertes en personas mayores de 5 anos,2005-04-01,1,1,3,3,4,4,8
MACHARETI,mortalidad institucional,otras muertes en personas mayores de 5 anos,2005-04-01,1,0,0,0,1,0,1
MAGDALENA,mortalidad institucional,otras muertes en personas mayores de 5 anos,2005-04-01,1,0,0,1,1,1,2
MIZQUE,mortalidad institucional,otras muertes en personas mayores de 5 anos,2005-04-01,0,0,1,0,1,0,1
MOCOMOCO,mortalidad institucional,otras muertes en personas mayores de 5 anos,2005-04-01,0,0,1,2,1,2,3
MONTEAGUDO,mortalidad institucional,otras muertes en personas mayores de 5 anos,2005-04-01,2,1,0,3,2,4,6
MONTERO,mortalidad institucional,otras muertes en personas mayores de 5 anos,2005-04-01,1,0,9,0,10,0,10
ORURO,mortalidad institucional,otras muertes en personas mayores de 5 anos,2005-04-01,16,11,3,7,19,18,37
PADILLA,mortalidad institucional,otras muertes en personas mayores de 5 anos,2005-04-01,0,0,0,1,0,1,1
PAILON,mortalidad institucional,otras muertes en personas mayores de 5 anos,2005-04-01,2,0,1,0,3,0,3
PAPEL PAMPA,mortalidad institucional,otras muertes en personas mayores de 5 anos,2005-04-01,0,0,0,1,0,1,1
PAZÃ‘A,mortalidad institucional,otras muertes en personas mayores de 5 anos,2005-04-01,0,0,1,1,1,1,2
PELECHUCO,mortalidad institucional,otras muertes en personas mayores de 5 anos,2005-04-01,0,0,1,0,1,0,1
POROMA,mortalidad institucional,otras muertes en personas mayores de 5 anos,2005-04-01,0,0,0,1,0,1,1
POTOSI,mortalidad institucional,otras muertes en personas mayores de 5 anos,2005-04-01,11,15,1,0,12,15,27
PRESTO,mortalidad institucional,otras muertes en personas mayores de 5 anos,2005-04-01,1,0,0,1,1,1,2
PUCARA,mortalidad institucional,otras muertes en personas mayores de 5 anos,2005-04-01,0,1,0,0,0,1,1
PUERTO ACOSTA,mortalidad institucional,otras muertes en personas mayores de 5 anos,2005-04-01,0,0,1,0,1,0,1
PUERTO VILLARROEL,mortalidad institucional,otras muertes en personas mayores de 5 anos,2005-04-01,1,1,2,0,3,1,4
PUNA,mortalidad institucional,otras muertes en personas mayores de 5 anos,2005-04-01,0,0,1,0,1,0,1
PUNATA,mortalidad institucional,otras muertes en personas mayores de 5 anos,2005-04-01,1,0,5,2,6,2,8
QUILLACOLLO,mortalidad institucional,otras muertes en personas mayores de 5 anos,2005-04-01,0,1,0,0,0,1,1
QUIME,mortalidad institucional,otras muertes en personas mayores de 5 anos,2005-04-01,0,0,1,0,1,0,1
RAVELO,mortalidad institucional,otras muertes en personas mayores de 5 anos,2005-04-01,1,0,0,0,1,0,1
RIBERALTA,mortalidad institucional,otras muertes en personas mayores de 5 anos,2005-04-01,2,1,1,0,3,1,4
SACABA,mortalidad institucional,otras muertes en personas mayores de 5 anos,2005-04-01,0,0,6,5,6,5,11
SALINAS DE GARCI MENDOZA,mortalidad institucional,otras muertes en personas mayores de 5 anos,2005-04-01,0,0,1,0,1,0,1
SAMAIPATA,mortalidad institucional,otras muertes en personas mayores de 5 anos,2005-04-01,0,0,1,0,1,0,1
SAN BENITO,mortalidad institucional,otras muertes en personas mayores de 5 anos,2005-04-01,0,0,1,0,1,0,1
SAN IGNACIO DE VELASCO,mortalidad institucional,otras muertes en personas mayores de 5 anos,2005-04-01,2,1,0,0,2,1,3
SAN JUAN DE YAPACANI,mortalidad institucional,otras muertes en personas mayores de 5 anos,2005-04-01,0,0,0,1,0,1,1
SAN JULIAN,mortalidad institucional,otras muertes en personas mayores de 5 anos,2005-04-01,1,0,0,0,1,0,1
SAN LUCAS,mortalidad institucional,otras muertes en personas mayores de 5 anos,2005-04-01,0,0,1,4,1,4,5
SAN PEDRO,mortalidad institucional,otras muertes en personas mayores de 5 anos,2005-04-01,1,0,0,0,1,0,1
SAN PEDRO DE BUENA VISTA,mortalidad institucional,otras muertes en personas mayores de 5 anos,2005-04-01,0,0,1,0,1,0,1
SANTA ANA,mortalidad institucional,otras muertes en personas mayores de 5 anos,2005-04-01,2,0,0,0,2,0,2
SANTA CRUZ DE LA SIERRA,mortalidad institucional,otras muertes en personas mayores de 5 anos,2005-04-01,0,7,0,0,0,7,7
SANTA ROSA,mortalidad institucional,otras muertes en personas mayores de 5 anos,2005-04-01,1,0,0,0,1,0,1
SIPE SIPE,mortalidad institucional,otras muertes en personas mayores de 5 anos,2005-04-01,0,1,1,0,1,1,2
SORATA,mortalidad institucional,otras muertes en personas mayores de 5 anos,2005-04-01,0,0,2,1,2,1,3
SUCRE,mortalidad institucional,otras muertes en personas mayores de 5 anos,2005-04-01,12,21,0,0,12,21,33
TAPACARI,mortalidad institucional,otras muertes en personas mayores de 5 anos,2005-04-01,0,0,0,1,0,1,1
TARABUCO,mortalidad institucional,otras muertes en personas mayores de 5 anos,2005-04-01,0,1,2,3,2,4,6
TARACO,mortalidad institucional,otras muertes en personas mayores de 5 anos,2005-04-01,0,0,2,0,2,0,2
TARIJA,mortalidad institucional,otras muertes en personas mayores de 5 anos,2005-04-01,18,8,1,3,19,11,30
TARVITA,mortalidad institucional,otras muertes en personas mayores de 5 anos,2005-04-01,0,0,3,3,3,3,6
TIQUIPAYA,mortalidad institucional,otras muertes en personas mayores de 5 anos,2005-04-01,0,0,2,0,2,0,2
TOCO,mortalidad institucional,otras muertes en personas mayores de 5 anos,2005-04-01,0,0,0,1,0,1,1
TOMINA,mortalidad institucional,otras muertes en personas mayores de 5 anos,2005-04-01,0,0,0,1,0,1,1
TRINIDAD,mortalidad institucional,otras muertes en personas mayores de 5 anos,2005-04-01,10,4,1,2,11,6,17
UNCIA,mortalidad institucional,otras muertes en personas mayores de 5 anos,2005-04-01,4,0,0,0,4,0,4
UYUNI,mortalidad institucional,otras muertes en personas mayores de 5 anos,2005-04-01,0,0,1,1,1,1,2
VALLEGRANDE,mortalidad institucional,otras muertes en personas mayores de 5 anos,2005-04-01,2,0,0,0,2,0,2
VILLA MONTES,mortalidad institucional,otras muertes en personas mayores de 5 anos,2005-04-01,1,0,0,0,1,0,1
VILLA SERRANO,mortalidad institucional,otras muertes en personas mayores de 5 anos,2005-04-01,0,0,0,2,0,2,2
VILLA TUNARI,mortalidad institucional,otras muertes en personas mayores de 5 anos,2005-04-01,1,1,0,0,1,1,2
VILLA VACA GUZMAN (MUYUPAMPA),mortalidad institucional,otras muertes en personas mayores de 5 anos,2005-04-01,0,1,1,0,1,1,2
VILLAZON,mortalidad institucional,otras muertes en personas mayores de 5 anos,2005-04-01,1,0,0,0,1,0,1
VITICHI,mortalidad institucional,otras muertes en personas mayores de 5 anos,2005-04-01,0,0,0,1,0,1,1
YACUIBA,mortalidad institucional,otras muertes en personas mayores de 5 anos,2005-04-01,0,1,0,0,0,1,1
YAMPARAEZ,mortalidad institucional,otras muertes en personas mayores de 5 anos,2005-04-01,0,0,1,1,1,1,2
YAPACANI,mortalidad institucional,otras muertes en personas mayores de 5 anos,2005-04-01,0,0,0,2,0,2,2
YOTALA,mortalidad institucional,otras muertes en personas mayores de 5 anos,2005-04-01,0,0,1,1,1,1,2
ACHACACHI,mortalidad institucional,otras muertes en personas mayores de 5 anos,2005-05-01,0,0,3,1,3,1,4
APOLO,mortalidad institucional,otras muertes en personas mayores de 5 anos,2005-05-01,1,0,0,0,1,0,1
ARAMPAMPA,mortalidad institucional,otras muertes en personas mayores de 5 anos,2005-05-01,0,0,1,0,1,0,1
AYOPAYA (V. DE INDEPENDENCIA),mortalidad institucional,otras muertes en personas mayores de 5 anos,2005-05-01,1,0,1,0,2,0,2
AZURDUY,mortalidad institucional,otras muertes en personas mayores de 5 anos,2005-05-01,0,0,2,0,2,0,2
BERMEJO,mortalidad institucional,otras muertes en personas mayores de 5 anos,2005-05-01,0,1,0,0,0,1,1
"CAIZA ""D""",mortalidad institucional,otras muertes en personas mayores de 5 anos,2005-05-01,2,0,0,0,2,0,2
CAJUATA,mortalidad institucional,otras muertes en personas mayores de 5 anos,2005-05-01,0,0,0,1,0,1,1
CALAMARCA,mortalidad institucional,otras muertes en personas mayores de 5 anos,2005-05-01,0,0,1,1,1,1,2
CAMARGO,mortalidad institucional,otras muertes en personas mayores de 5 anos,2005-05-01,0,0,2,1,2,1,3
CAMATAQUI (C. VILLA ABECIA),mortalidad institucional,otras muertes en personas mayores de 5 anos,2005-05-01,0,0,0,1,0,1,1
CAMIRI,mortalidad institucional,otras muertes en personas mayores de 5 anos,2005-05-01,3,1,0,0,3,1,4
CAPINOTA,mortalidad institucional,otras muertes en personas mayores de 5 anos,2005-05-01,0,0,5,2,5,2,7
CARANAVI,mortalidad institucional,otras muertes en personas mayores de 5 anos,2005-05-01,4,1,2,1,6,2,8
CHALLAPATA,mortalidad institucional,otras muertes en personas mayores de 5 anos,2005-05-01,0,0,3,4,3,4,7
CHARAGUA,mortalidad institucional,otras muertes en personas mayores de 5 anos,2005-05-01,1,0,0,0,1,0,1
CHARAÃ‘A,mortalidad institucional,otras muertes en personas mayores de 5 anos,2005-05-01,0,0,1,0,1,0,1
CHAYANTA,mortalidad institucional,otras muertes en personas mayores de 5 anos,2005-05-01,0,0,0,1,0,1,1
COCHABAMBA,mortalidad institucional,otras muertes en personas mayores de 5 anos,2005-05-01,47,35,3,1,50,36,86
COLCAPIRHUA,mortalidad institucional,otras muertes en personas mayores de 5 anos,2005-05-01,1,0,0,0,1,0,1
"COLCHA ""K""",mortalidad institucional,otras muertes en personas mayores de 5 anos,2005-05-01,0,0,1,1,1,1,2
COLLANA,mortalidad institucional,otras muertes en personas mayores de 5 anos,2005-05-01,0,0,2,0,2,0,2
COLOMI,mortalidad institucional,otras muertes en personas mayores de 5 anos,2005-05-01,0,0,2,1,2,1,3
COLQUENCHA,mortalidad institucional,otras muertes en personas mayores de 5 anos,2005-05-01,0,0,1,1,1,1,2
COPACABANA,mortalidad institucional,otras muertes en personas mayores de 5 anos,2005-05-01,1,0,0,0,1,0,1
COROICO,mortalidad institucional,otras muertes en personas mayores de 5 anos,2005-05-01,2,0,0,3,2,3,5
CULPINA,mortalidad institucional,otras muertes en personas mayores de 5 anos,2005-05-01,0,0,0,2,0,2,2
EL ALTO,mortalidad institucional,otras muertes en personas mayores de 5 anos,2005-05-01,6,1,3,2,9,3,12
EUCALIPTUS,mortalidad institucional,otras muertes en personas mayores de 5 anos,2005-05-01,0,0,3,0,3,0,3
GUANAY,mortalidad institucional,otras muertes en personas mayores de 5 anos,2005-05-01,0,0,3,0,3,0,3
GUAYARAMERIN,mortalidad institucional,otras muertes en personas mayores de 5 anos,2005-05-01,4,1,0,1,4,2,6
HUACARETA,mortalidad institucional,otras muertes en personas mayores de 5 anos,2005-05-01,2,0,0,0,2,0,2
HUANUNI,mortalidad institucional,otras muertes en personas mayores de 5 anos,2005-05-01,0,0,2,0,2,0,2
ICLA,mortalidad institucional,otras muertes en personas mayores de 5 anos,2005-05-01,0,0,2,1,2,1,3
INCAHUASI,mortalidad institucional,otras muertes en personas mayores de 5 anos,2005-05-01,0,0,2,0,2,0,2
LA PAZ,mortalidad institucional,otras muertes en personas mayores de 5 anos,2005-05-01,82,86,10,9,92,95,187
LAS CARRERAS,mortalidad institucional,otras muertes en personas mayores de 5 anos,2005-05-01,0,0,1,0,1,0,1
LLALLAGUA,mortalidad institucional,otras muertes en personas mayores de 5 anos,2005-05-01,2,0,2,1,4,1,5
LORETO,mortalidad institucional,otras muertes en personas mayores de 5 anos,2005-05-01,0,0,0,1,0,1,1
LURIBAY,mortalidad institucional,otras muertes en personas mayores de 5 anos,2005-05-01,0,0,1,0,1,0,1
MIZQUE,mortalidad institucional,otras muertes en personas mayores de 5 anos,2005-05-01,0,0,3,5,3,5,8
MOCOMOCO,mortalidad institucional,otras muertes en personas mayores de 5 anos,2005-05-01,0,0,0,1,0,1,1
MONTEAGUDO,mortalidad institucional,otras muertes en personas mayores de 5 anos,2005-05-01,1,2,2,1,3,3,6
MONTERO,mortalidad institucional,otras muertes en personas mayores de 5 anos,2005-05-01,0,1,7,0,7,1,8
ORURO,mortalidad institucional,otras muertes en personas mayores de 5 anos,2005-05-01,17,14,4,5,21,19,40
PADILLA,mortalidad institucional,otras muertes en personas mayores de 5 anos,2005-05-01,1,0,1,1,2,1,3
PAILON,mortalidad institucional,otras muertes en personas mayores de 5 anos,2005-05-01,0,0,1,0,1,0,1
POCOATA,mortalidad institucional,otras muertes en personas mayores de 5 anos,2005-05-01,0,0,1,0,1,0,1
POROMA,mortalidad institucional,otras muertes en personas mayores de 5 anos,2005-05-01,0,0,3,1,3,1,4
PORVENIR,mortalidad institucional,otras muertes en personas mayores de 5 anos,2005-05-01,1,0,0,0,1,0,1
POTOSI,mortalidad institucional,otras muertes en personas mayores de 5 anos,2005-05-01,14,9,0,1,14,10,24
PRESTO,mortalidad institucional,otras muertes en personas mayores de 5 anos,2005-05-01,0,0,3,0,3,0,3
PUCARA,mortalidad institucional,otras muertes en personas mayores de 5 anos,2005-05-01,0,0,0,2,0,2,2
PUERTO ACOSTA,mortalidad institucional,otras muertes en personas mayores de 5 anos,2005-05-01,0,0,0,1,0,1,1
PUERTO CARABUCO,mortalidad institucional,otras muertes en personas mayores de 5 anos,2005-05-01,0,0,3,0,3,0,3
PUERTO VILLARROEL,mortalidad institucional,otras muertes en personas mayores de 5 anos,2005-05-01,1,0,3,1,4,1,5
PUNA,mortalidad institucional,otras muertes en personas mayores de 5 anos,2005-05-01,0,0,2,0,2,0,2
PUNATA,mortalidad institucional,otras muertes en personas mayores de 5 anos,2005-05-01,1,0,1,3,2,3,5
RAVELO,mortalidad institucional,otras muertes en personas mayores de 5 anos,2005-05-01,0,0,1,3,1,3,4
RIBERALTA,mortalidad institucional,otras muertes en personas mayores de 5 anos,2005-05-01,0,1,1,0,1,1,2
RURRENABAQUE,mortalidad institucional,otras muertes en personas mayores de 5 anos,2005-05-01,2,0,0,0,2,0,2
SACABA,mortalidad institucional,otras muertes en personas mayores de 5 anos,2005-05-01,2,0,8,5,10,5,15
SACACA,mortalidad institucional,otras muertes en personas mayores de 5 anos,2005-05-01,0,0,2,0,2,0,2
SAN IGNACIO DE VELASCO,mortalidad institucional,otras muertes en personas mayores de 5 anos,2005-05-01,2,3,0,0,2,3,5
SAN JAVIER(BNI),mortalidad institucional,otras muertes en personas mayores de 5 anos,2005-05-01,1,0,0,0,1,0,1
SAN JOSE DE CHIQUITOS,mortalidad institucional,otras muertes en personas mayores de 5 anos,2005-05-01,0,0,1,1,1,1,2
SAN JUAN DE YAPACANI,mortalidad institucional,otras muertes en personas mayores de 5 anos,2005-05-01,0,0,0,1,0,1,1
SAN LORENZO(TJA),mortalidad institucional,otras muertes en personas mayores de 5 anos,2005-05-01,0,0,0,2,0,2,2
SAN LUCAS,mortalidad institucional,otras muertes en personas mayores de 5 anos,2005-05-01,0,0,9,4,9,4,13
SAN PABLO DE LIPEZ,mortalidad institucional,otras muertes en personas mayores de 5 anos,2005-05-01,0,0,0,2,0,2,2
SAN PEDRO DE BUENA VISTA,mortalidad institucional,otras muertes en personas mayores de 5 anos,2005-05-01,0,0,1,0,1,0,1
SAN PEDRO DE QUEMES,mortalidad institucional,otras muertes en personas mayores de 5 anos,2005-05-01,0,0,1,0,1,0,1
SAN RAMON,mortalidad institucional,otras muertes en personas mayores de 5 anos,2005-05-01,0,0,0,2,0,2,2
SANTA ANA,mortalidad institucional,otras muertes en personas mayores de 5 anos,2005-05-01,1,2,0,0,1,2,3
SORATA,mortalidad institucional,otras muertes en personas mayores de 5 anos,2005-05-01,0,0,1,0,1,0,1
SUCRE,mortalidad institucional,otras muertes en personas mayores de 5 anos,2005-05-01,10,9,0,0,10,9,19
TARABUCO,mortalidad institucional,otras muertes en personas mayores de 5 anos,2005-05-01,0,0,0,1,0,1,1
TARIJA,mortalidad institucional,otras muertes en personas mayores de 5 anos,2005-05-01,21,9,3,0,24,9,33
TARVITA,mortalidad institucional,otras muertes en personas mayores de 5 anos,2005-05-01,0,0,2,0,2,0,2
TIQUIPAYA,mortalidad institucional,otras muertes en personas mayores de 5 anos,2005-05-01,0,0,0,1,0,1,1
TOCO,mortalidad institucional,otras muertes en personas mayores de 5 anos,2005-05-01,0,0,1,0,1,0,1
TOTORA(CBBA),mortalidad institucional,otras muertes en personas mayores de 5 anos,2005-05-01,1,0,0,0,1,0,1
TOTORA(ORR),mortalidad institucional,otras muertes en personas mayores de 5 anos,2005-05-01,1,0,0,0,1,0,1
TRINIDAD,mortalidad institucional,otras muertes en personas mayores de 5 anos,2005-05-01,12,6,4,2,16,8,24
TUPIZA,mortalidad institucional,otras muertes en personas mayores de 5 anos,2005-05-01,0,0,0,2,0,2,2
UNCIA,mortalidad institucional,otras muertes en personas mayores de 5 anos,2005-05-01,2,0,0,0,2,0,2
UYUNI,mortalidad institucional,otras muertes en personas mayores de 5 anos,2005-05-01,0,0,1,4,1,4,5
VILLA MONTES,mortalidad institucional,otras muertes en personas mayores de 5 anos,2005-05-01,3,0,1,0,4,0,4
VILLA TUNARI,mortalidad institucional,otras muertes en personas mayores de 5 anos,2005-05-01,0,1,0,0,0,1,1
VILLA VACA GUZMAN (MUYUPAMPA),mortalidad institucional,otras muertes en personas mayores de 5 anos,2005-05-01,0,0,0,1,0,1,1
VILLAZON,mortalidad institucional,otras muertes en personas mayores de 5 anos,2005-05-01,2,1,0,0,2,1,3
YACUIBA,mortalidad institucional,otras muertes en personas mayores de 5 anos,2005-05-01,3,2,0,0,3,2,5
YAMPARAEZ,mortalidad institucional,otras muertes en personas mayores de 5 anos,2005-05-01,0,0,1,0,1,0,1
ANCORAIMES,mortalidad institucional,otras muertes en personas mayores de 5 anos,2005-06-01,0,0,0,1,0,1,1
ARQUE,mortalidad institucional,otras muertes en personas mayores de 5 anos,2005-06-01,0,0,1,0,1,0,1
AUCAPATA,mortalidad institucional,otras muertes en personas mayores de 5 anos,2005-06-01,0,0,0,1,0,1,1
AYOPAYA (V. DE INDEPENDENCIA),mortalidad institucional,otras muertes en personas mayores de 5 anos,2005-06-01,2,0,0,1,2,1,3
AZURDUY,mortalidad institucional,otras muertes en personas mayores de 5 anos,2005-06-01,1,0,0,2,1,2,3
BATALLAS,mortalidad institucional,otras muertes en personas mayores de 5 anos,2005-06-01,0,0,0,1,0,1,1
BERMEJO,mortalidad institucional,otras muertes en personas mayores de 5 anos,2005-06-01,0,0,1,0,1,0,1
BETANZOS,mortalidad institucional,otras muertes en personas mayores de 5 anos,2005-06-01,1,1,1,1,2,2,4
BOYUIBE,mortalidad institucional,otras muertes en personas mayores de 5 anos,2005-06-01,1,0,0,0,1,0,1
BUENA VISTA,mortalidad institucional,otras muertes en personas mayores de 5 anos,2005-06-01,1,0,2,0,3,0,3
"CAIZA ""D""",mortalidad institucional,otras muertes en personas mayores de 5 anos,2005-06-01,0,0,1,0,1,0,1
CAMARGO,mortalidad institucional,otras muertes en personas mayores de 5 anos,2005-06-01,1,0,0,1,1,1,2
CAMATAQUI (C. VILLA ABECIA),mortalidad institucional,otras muertes en personas mayores de 5 anos,2005-06-01,0,1,0,0,0,1,1
CAMIRI,mortalidad institucional,otras muertes en personas mayores de 5 anos,2005-06-01,3,1,0,0,3,1,4
CAPINOTA,mortalidad institucional,otras muertes en personas mayores de 5 anos,2005-06-01,0,0,0,1,0,1,1
CARANAVI,mortalidad institucional,otras muertes en personas mayores de 5 anos,2005-06-01,1,0,5,6,6,6,12
CHALLAPATA,mortalidad institucional,otras muertes en personas mayores de 5 anos,2005-06-01,0,0,4,5,4,5,9
CHAQUI,mortalidad institucional,otras muertes en personas mayores de 5 anos,2005-06-01,0,0,1,2,1,2,3
CHARAGUA,mortalidad institucional,otras muertes en personas mayores de 5 anos,2005-06-01,0,0,0,1,0,1,1
CHIMORE,mortalidad institucional,otras muertes en personas mayores de 5 anos,2005-06-01,0,0,1,1,1,1,2
COBIJA,mortalidad institucional,otras muertes en personas mayores de 5 anos,2005-06-01,2,1,1,0,3,1,4
COCHABAMBA,mortalidad institucional,otras muertes en personas mayores de 5 anos,2005-06-01,54,29,3,6,57,35,92
COIPASA,mortalidad institucional,otras muertes en personas mayores de 5 anos,2005-06-01,0,0,1,0,1,0,1
COLCAPIRHUA,mortalidad institucional,otras muertes en personas mayores de 5 anos,2005-06-01,1,0,0,0,1,0,1
COLLANA,mortalidad institucional,otras muertes en personas mayores de 5 anos,2005-06-01,0,0,1,0,1,0,1
COLOMI,mortalidad institucional,otras muertes en personas mayores de 5 anos,2005-06-01,0,0,1,1,1,1,2
CORIPATA,mortalidad institucional,otras muertes en personas mayores de 5 anos,2005-06-01,1,0,0,0,1,0,1
CORO CORO,mortalidad institucional,otras muertes en personas mayores de 5 anos,2005-06-01,0,1,0,0,0,1,1
COROICO,mortalidad institucional,otras muertes en personas mayores de 5 anos,2005-06-01,2,1,0,0,2,1,3
COTOCA,mortalidad institucional,otras muertes en personas mayores de 5 anos,2005-06-01,0,0,2,1,2,1,3
CULPINA,mortalidad institucional,otras muertes en personas mayores de 5 anos,2005-06-01,0,0,0,3,0,3,3
EL ALTO,mortalidad institucional,otras muertes en personas mayores de 5 anos,2005-06-01,5,8,5,3,10,11,21
EUCALIPTUS,mortalidad institucional,otras muertes en personas mayores de 5 anos,2005-06-01,0,0,3,1,3,1,4
FERNANDEZ ALONSO,mortalidad institucional,otras muertes en personas mayores de 5 anos,2005-06-01,0,0,1,1,1,1,2
GENERAL SAAVEDRA,mortalidad institucional,otras muertes en personas mayores de 5 anos,2005-06-01,0,0,1,0,1,0,1
GRAL. J.J. PEREZ (CHARAZANI),mortalidad institucional,otras muertes en personas mayores de 5 anos,2005-06-01,0,0,1,1,1,1,2
GUANAY,mortalidad institucional,otras muertes en personas mayores de 5 anos,2005-06-01,1,0,1,0,2,0,2
GUAYARAMERIN,mortalidad institucional,otras muertes en personas mayores de 5 anos,2005-06-01,5,2,0,0,5,2,7
HUACARETA,mortalidad institucional,otras muertes en personas mayores de 5 anos,2005-06-01,0,0,1,0,1,0,1
HUANUNI,mortalidad institucional,otras muertes en personas mayores de 5 anos,2005-06-01,0,0,0,1,0,1,1
ICLA,mortalidad institucional,otras muertes en personas mayores de 5 anos,2005-06-01,0,0,1,1,1,1,2
IRUPANA (VILLA DE LANZA),mortalidad institucional,otras muertes en personas mayores de 5 anos,2005-06-01,1,1,1,0,2,1,3
LA PAZ,mortalidad institucional,otras muertes en personas mayores de 5 anos,2005-06-01,93,77,10,4,103,81,184
LAGUNILLAS,mortalidad institucional,otras muertes en personas mayores de 5 anos,2005-06-01,0,1,0,0,0,1,1
LLALLAGUA,mortalidad institucional,otras muertes en personas mayores de 5 anos,2005-06-01,1,3,1,4,2,7,9
LORETO,mortalidad institucional,otras muertes en personas mayores de 5 anos,2005-06-01,0,0,0,1,0,1,1
MINEROS,mortalidad institucional,otras muertes en personas mayores de 5 anos,2005-06-01,0,0,1,2,1,2,3
MIZQUE,mortalidad institucional,otras muertes en personas mayores de 5 anos,2005-06-01,1,0,0,2,1,2,3
MOCOMOCO,mortalidad institucional,otras muertes en personas mayores de 5 anos,2005-06-01,0,0,0,3,0,3,3
MOJOCOYA,mortalidad institucional,otras muertes en personas mayores de 5 anos,2005-06-01,0,0,0,1,0,1,1
MONTEAGUDO,mortalidad institucional,otras muertes en personas mayores de 5 anos,2005-06-01,1,0,0,3,1,3,4
MONTERO,mortalidad institucional,otras muertes en personas mayores de 5 anos,2005-06-01,1,0,7,1,8,1,9
OCURI,mortalidad institucional,otras muertes en personas mayores de 5 anos,2005-06-01,0,0,1,1,1,1,2
OKINAWA,mortalidad institucional,otras muertes en personas mayores de 5 anos,2005-06-01,0,0,1,0,1,0,1
ORURO,mortalidad institucional,otras muertes en personas mayores de 5 anos,2005-06-01,15,22,8,3,23,25,48
PADILLA,mortalidad institucional,otras muertes en personas mayores de 5 anos,2005-06-01,0,0,0,3,0,3,3
PAILON,mortalidad institucional,otras muertes en personas mayores de 5 anos,2005-06-01,0,0,0,1,0,1,1
PALOS BLANCOS,mortalidad institucional,otras muertes en personas mayores de 5 anos,2005-06-01,0,0,0,1,0,1,1
PAPEL PAMPA,mortalidad institucional,otras muertes en personas mayores de 5 anos,2005-06-01,0,1,0,1,0,2,2
POROMA,mortalidad institucional,otras muertes en personas mayores de 5 anos,2005-06-01,0,0,2,1,2,1,3
PORTACHUELO,mortalidad institucional,otras muertes en personas mayores de 5 anos,2005-06-01,0,0,0,1,0,1,1
POTOSI,mortalidad institucional,otras muertes en personas mayores de 5 anos,2005-06-01,13,9,0,0,13,9,22
PRESTO,mortalidad institucional,otras muertes en personas mayores de 5 anos,2005-06-01,0,0,1,2,1,2,3
PUCARANI,mortalidad institucional,otras muertes en personas mayores de 5 anos,2005-06-01,0,1,0,0,0,1,1
PUERTO ACOSTA,mortalidad institucional,otras muertes en personas mayores de 5 anos,2005-06-01,1,1,0,2,1,3,4
PUERTO CARABUCO,mortalidad institucional,otras muertes en personas mayores de 5 anos,2005-06-01,0,0,1,1,1,1,2
PUERTO QUIJARRO,mortalidad institucional,otras muertes en personas mayores de 5 anos,2005-06-01,1,0,0,0,1,0,1
PUERTO RICO,mortalidad institucional,otras muertes en personas mayores de 5 anos,2005-06-01,1,0,0,0,1,0,1
PUERTO SUAREZ,mortalidad institucional,otras muertes en personas mayores de 5 anos,2005-06-01,0,3,0,0,0,3,3
PUERTO VILLARROEL,mortalidad institucional,otras muertes en personas mayores de 5 anos,2005-06-01,0,0,0,1,0,1,1
PUNA,mortalidad institucional,otras muertes en personas mayores de 5 anos,2005-06-01,0,1,1,0,1,1,2
PUNATA,mortalidad institucional,otras muertes en personas mayores de 5 anos,2005-06-01,0,2,12,4,12,6,18
QUILLACOLLO,mortalidad institucional,otras muertes en personas mayores de 5 anos,2005-06-01,0,1,0,0,0,1,1
QUIME,mortalidad institucional,otras muertes en personas mayores de 5 anos,2005-06-01,1,0,0,0,1,0,1
RAVELO,mortalidad institucional,otras muertes en personas mayores de 5 anos,2005-06-01,0,0,0,3,0,3,3
RIBERALTA,mortalidad institucional,otras muertes en personas mayores de 5 anos,2005-06-01,4,3,3,2,7,5,12
SACABA,mortalidad institucional,otras muertes en personas mayores de 5 anos,2005-06-01,1,4,6,9,7,13,20
SACACA,mortalidad institucional,otras muertes en personas mayores de 5 anos,2005-06-01,0,0,1,0,1,0,1
SAN CARLOS,mortalidad institucional,otras muertes en personas mayores de 5 anos,2005-06-01,0,0,2,1,2,1,3
SAN IGNACIO DE VELASCO,mortalidad institucional,otras muertes en personas mayores de 5 anos,2005-06-01,2,2,1,0,3,2,5
SAN JUAN DE YAPACANI,mortalidad institucional,otras muertes en personas mayores de 5 anos,2005-06-01,0,0,0,2,0,2,2
SAN LUCAS,mortalidad institucional,otras muertes en personas mayores de 5 anos,2005-06-01,0,1,4,3,4,4,8
SAN PEDRO DE BUENA VISTA,mortalidad institucional,otras muertes en personas mayores de 5 anos,2005-06-01,0,0,0,1,0,1,1
SAN RAFAEL,mortalidad institucional,otras muertes en personas mayores de 5 anos,2005-06-01,0,0,0,1,0,1,1
SANTA ANA,mortalidad institucional,otras muertes en personas mayores de 5 anos,2005-06-01,2,2,0,0,2,2,4
SANTA CRUZ DE LA SIERRA,mortalidad institucional,otras muertes en personas mayores de 5 anos,2005-06-01,0,23,0,0,0,23,23
SIPE SIPE,mortalidad institucional,otras muertes en personas mayores de 5 anos,2005-06-01,0,0,0,1,0,1,1
SOPACHUY,mortalidad institucional,otras muertes en personas mayores de 5 anos,2005-06-01,1,1,1,0,2,1,3
SUCRE,mortalidad institucional,otras muertes en personas mayores de 5 anos,2005-06-01,29,20,0,0,29,20,49
TAPACARI,mortalidad institucional,otras muertes en personas mayores de 5 anos,2005-06-01,0,0,3,0,3,0,3
TARABUCO,mortalidad institucional,otras muertes en personas mayores de 5 anos,2005-06-01,0,0,0,4,0,4,4
TARIJA,mortalidad institucional,otras muertes en personas mayores de 5 anos,2005-06-01,21,15,5,1,26,16,42
TARVITA,mortalidad institucional,otras muertes en personas mayores de 5 anos,2005-06-01,0,0,4,0,4,0,4
TIPUANI,mortalidad institucional,otras muertes en personas mayores de 5 anos,2005-06-01,0,0,1,0,1,0,1
TITO YUPANQUI (PARQUIPUJIO),mortalidad institucional,otras muertes en personas mayores de 5 anos,2005-06-01,0,0,0,1,0,1,1
TOMINA,mortalidad institucional,otras muertes en personas mayores de 5 anos,2005-06-01,0,0,2,0,2,0,2
TORO TORO,mortalidad institucional,otras muertes en personas mayores de 5 anos,2005-06-01,0,0,1,0,1,0,1
TRINIDAD,mortalidad institucional,otras muertes en personas mayores de 5 anos,2005-06-01,5,8,1,5,6,13,19
TUPIZA,mortalidad institucional,otras muertes en personas mayores de 5 anos,2005-06-01,1,2,0,0,1,2,3
URIONDO (A. CONCEPCION),mortalidad institucional,otras muertes en personas mayores de 5 anos,2005-06-01,0,0,1,0,1,0,1
VACAS,mortalidad institucional,otras muertes en personas mayores de 5 anos,2005-06-01,0,0,2,0,2,0,2
VALLEGRANDE,mortalidad institucional,otras muertes en personas mayores de 5 anos,2005-06-01,2,1,0,0,2,1,3
VILLA MONTES,mortalidad institucional,otras muertes en personas mayores de 5 anos,2005-06-01,1,0,5,0,6,0,6
VILLA SERRANO,mortalidad institucional,otras muertes en personas mayores de 5 anos,2005-06-01,0,0,1,0,1,0,1
VILLA TUNARI,mortalidad institucional,otras muertes en personas mayores de 5 anos,2005-06-01,1,0,0,0,1,0,1
VILLAZON,mortalidad institucional,otras muertes en personas mayores de 5 anos,2005-06-01,0,1,1,1,1,2,3
WARNES,mortalidad institucional,otras muertes en personas mayores de 5 anos,2005-06-01,2,1,1,0,3,1,4
YACUIBA,mortalidad institucional,otras muertes en personas mayores de 5 anos,2005-06-01,3,1,0,0,3,1,4
YAMPARAEZ,mortalidad institucional,otras muertes en personas mayores de 5 anos,2005-06-01,0,0,0,2,0,2,2
YAPACANI,mortalidad institucional,otras muertes en personas mayores de 5 anos,2005-06-01,1,1,0,1,1,2,3
YOTALA,mortalidad institucional,otras muertes en personas mayores de 5 anos,2005-06-01,0,0,0,2,0,2,2
ACHACACHI,mortalidad institucional,otras muertes en personas mayores de 5 anos,2005-07-01,0,0,1,0,1,0,1
AIQUILE,mortalidad institucional,otras muertes en personas mayores de 5 anos,2005-07-01,0,0,0,1,0,1,1
ATOCHA,mortalidad institucional,otras muertes en personas mayores de 5 anos,2005-07-01,0,1,0,0,0,1,1
AYATA,mortalidad institucional,otras muertes en personas mayores de 5 anos,2005-07-01,1,0,0,0,1,0,1
AYOPAYA (V. DE INDEPENDENCIA),mortalidad institucional,otras muertes en personas mayores de 5 anos,2005-07-01,0,0,1,0,1,0,1
BELEN DE ANDAMARCA,mortalidad institucional,otras muertes en personas mayores de 5 anos,2005-07-01,0,0,2,0,2,0,2
BETANZOS,mortalidad institucional,otras muertes en personas mayores de 5 anos,2005-07-01,2,0,5,3,7,3,10
BOLPEBRA,mortalidad institucional,otras muertes en personas mayores de 5 anos,2005-07-01,0,0,0,1,0,1,1
BUENA VISTA,mortalidad institucional,otras muertes en personas mayores de 5 anos,2005-07-01,0,0,1,3,1,3,4
"CAIZA ""D""",mortalidad institucional,otras muertes en personas mayores de 5 anos,2005-07-01,0,0,0,2,0,2,2
CALAMARCA,mortalidad institucional,otras muertes en personas mayores de 5 anos,2005-07-01,0,0,1,0,1,0,1
CAMARGO,mortalidad institucional,otras muertes en personas mayores de 5 anos,2005-07-01,1,0,0,0,1,0,1
CAMIRI,mortalidad institucional,otras muertes en personas mayores de 5 anos,2005-07-01,2,3,1,1,3,4,7
CARANAVI,mortalidad institucional,otras muertes en personas mayores de 5 anos,2005-07-01,0,1,11,11,11,12,23
CHALLAPATA,mortalidad institucional,otras muertes en personas mayores de 5 anos,2005-07-01,0,0,2,0,2,0,2
CHARAÃ‘A,mortalidad institucional,otras muertes en personas mayores de 5 anos,2005-07-01,0,0,2,0,2,0,2
CHAYANTA,mortalidad institucional,otras muertes en personas mayores de 5 anos,2005-07-01,0,0,1,0,1,0,1
CHULUMANI (V. DE LA LIBERTAD),mortalidad institucional,otras muertes en personas mayores de 5 anos,2005-07-01,0,3,0,0,0,3,3
COCHABAMBA,mortalidad institucional,otras muertes en personas mayores de 5 anos,2005-07-01,43,24,0,1,43,25,68
COLPA BELGICA,mortalidad institucional,otras muertes en personas mayores de 5 anos,2005-07-01,0,0,1,0,1,0,1
COLQUECHACA,mortalidad institucional,otras muertes en personas mayores de 5 anos,2005-07-01,0,0,2,0,2,0,2
COMARAPA,mortalidad institucional,otras muertes en personas mayores de 5 anos,2005-07-01,1,0,0,0,1,0,1
COPACABANA,mortalidad institucional,otras muertes en personas mayores de 5 anos,2005-07-01,0,0,3,2,3,2,5
CORIPATA,mortalidad institucional,otras muertes en personas mayores de 5 anos,2005-07-01,0,0,0,3,0,3,3
CORQUE,mortalidad institucional,otras muertes en personas mayores de 5 anos,2005-07-01,0,0,0,1,0,1,1
COTAGAITA,mortalidad institucional,otras muertes en personas mayores de 5 anos,2005-07-01,0,0,1,0,1,0,1
COTOCA,mortalidad institucional,otras muertes en personas mayores de 5 anos,2005-07-01,0,0,1,1,1,1,2
CULPINA,mortalidad institucional,otras muertes en personas mayores de 5 anos,2005-07-01,1,0,0,1,1,1,2
DESAGUADERO,mortalidad institucional,otras muertes en personas mayores de 5 anos,2005-07-01,0,0,0,1,0,1,1
EL ALTO,mortalidad institucional,otras muertes en personas mayores de 5 anos,2005-07-01,4,3,3,3,7,6,13
EL TORNO,mortalidad institucional,otras muertes en personas mayores de 5 anos,2005-07-01,0,0,1,2,1,2,3
FERNANDEZ ALONSO,mortalidad institucional,otras muertes en personas mayores de 5 anos,2005-07-01,0,0,1,0,1,0,1
HUACARETA,mortalidad institucional,otras muertes en personas mayores de 5 anos,2005-07-01,0,0,1,1,1,1,2
HUANUNI,mortalidad institucional,otras muertes en personas mayores de 5 anos,2005-07-01,0,1,5,4,5,5,10
ICLA,mortalidad institucional,otras muertes en personas mayores de 5 anos,2005-07-01,0,0,0,1,0,1,1
INCAHUASI,mortalidad institucional,otras muertes en personas mayores de 5 anos,2005-07-01,0,0,0,3,0,3,3
IRUPANA (VILLA DE LANZA),mortalidad institucional,otras muertes en personas mayores de 5 anos,2005-07-01,0,0,2,0,2,0,2
LA PAZ,mortalidad institucional,otras muertes en personas mayores de 5 anos,2005-07-01,82,69,3,10,85,79,164
LLALLAGUA,mortalidad institucional,otras muertes en personas mayores de 5 anos,2005-07-01,1,0,3,3,4,3,7
LORETO,mortalidad institucional,otras muertes en personas mayores de 5 anos,2005-07-01,0,0,1,0,1,0,1
LURIBAY,mortalidad institucional,otras muertes en personas mayores de 5 anos,2005-07-01,0,0,0,2,0,2,2
MAGDALENA,mortalidad institucional,otras muertes en personas mayores de 5 anos,2005-07-01,1,1,2,1,3,2,5
MINEROS,mortalidad institucional,otras muertes en personas mayores de 5 anos,2005-07-01,0,0,1,0,1,0,1
MIZQUE,mortalidad institucional,otras muertes en personas mayores de 5 anos,2005-07-01,0,0,3,5,3,5,8
MOCOMOCO,mortalidad institucional,otras muertes en personas mayores de 5 anos,2005-07-01,0,0,0,1,0,1,1
MONTEAGUDO,mortalidad institucional,otras muertes en personas mayores de 5 anos,2005-07-01,0,1,1,0,1,1,2
MONTERO,mortalidad institucional,otras muertes en personas mayores de 5 anos,2005-07-01,0,0,4,2,4,2,6
OCURI,mortalidad institucional,otras muertes en personas mayores de 5 anos,2005-07-01,0,0,1,1,1,1,2
ORURO,mortalidad institucional,otras muertes en personas mayores de 5 anos,2005-07-01,25,11,1,4,26,15,41
PADCAYA,mortalidad institucional,otras muertes en personas mayores de 5 anos,2005-07-01,0,0,1,0,1,0,1
PADILLA,mortalidad institucional,otras muertes en personas mayores de 5 anos,2005-07-01,0,0,1,1,1,1,2
PAPEL PAMPA,mortalidad institucional,otras muertes en personas mayores de 5 anos,2005-07-01,0,0,0,1,0,1,1
PASORAPA,mortalidad institucional,otras muertes en personas mayores de 5 anos,2005-07-01,0,0,0,1,0,1,1
POTOSI,mortalidad institucional,otras muertes en personas mayores de 5 anos,2005-07-01,24,12,2,0,26,12,38
PRESTO,mortalidad institucional,otras muertes en personas mayores de 5 anos,2005-07-01,0,0,1,2,1,2,3
PUCARANI,mortalidad institucional,otras muertes en personas mayores de 5 anos,2005-07-01,0,0,0,1,0,1,1
PUERTO ACOSTA,mortalidad institucional,otras muertes en personas mayores de 5 anos,2005-07-01,0,0,0,1,0,1,1
PUERTO CARABUCO,mortalidad institucional,otras muertes en personas mayores de 5 anos,2005-07-01,0,0,1,0,1,0,1
PUERTO VILLARROEL,mortalidad institucional,otras muertes en personas mayores de 5 anos,2005-07-01,0,0,2,1,2,1,3
PUNA,mortalidad institucional,otras muertes en personas mayores de 5 anos,2005-07-01,1,0,2,1,3,1,4
PUNATA,mortalidad institucional,otras muertes en personas mayores de 5 anos,2005-07-01,3,2,1,2,4,4,8
RAVELO,mortalidad institucional,otras muertes en personas mayores de 5 anos,2005-07-01,1,0,1,2,2,2,4
RIBERALTA,mortalidad institucional,otras muertes en personas mayores de 5 anos,2005-07-01,4,0,9,2,13,2,15
SACABA,mortalidad institucional,otras muertes en personas mayores de 5 anos,2005-07-01,0,2,6,10,6,12,18
SAN AGUSTIN,mortalidad institucional,otras muertes en personas mayores de 5 anos,2005-07-01,0,0,2,0,2,0,2
SAN CARLOS,mortalidad institucional,otras muertes en personas mayores de 5 anos,2005-07-01,0,1,0,0,0,1,1
SAN IGNACIO DE VELASCO,mortalidad institucional,otras muertes en personas mayores de 5 anos,2005-07-01,3,2,0,1,3,3,6
SAN JAVIER(BNI),mortalidad institucional,otras muertes en personas mayores de 5 anos,2005-07-01,0,0,0,1,0,1,1
SAN JAVIER(STC),mortalidad institucional,otras muertes en personas mayores de 5 anos,2005-07-01,1,0,0,0,1,0,1
SAN JUAN DE YAPACANI,mortalidad institucional,otras muertes en personas mayores de 5 anos,2005-07-01,0,0,1,0,1,0,1
SAN JULIAN,mortalidad institucional,otras muertes en personas mayores de 5 anos,2005-07-01,1,0,0,0,1,0,1
SAN LUCAS,mortalidad institucional,otras muertes en personas mayores de 5 anos,2005-07-01,0,0,4,0,4,0,4
SAN PEDRO,mortalidad institucional,otras muertes en personas mayores de 5 anos,2005-07-01,0,0,0,3,0,3,3
SAN PEDRO DE BUENA VISTA,mortalidad institucional,otras muertes en personas mayores de 5 anos,2005-07-01,0,0,0,1,0,1,1
SAN RAMON,mortalidad institucional,otras muertes en personas mayores de 5 anos,2005-07-01,1,0,0,0,1,0,1
SANTA ANA,mortalidad institucional,otras muertes en personas mayores de 5 anos,2005-07-01,2,0,0,0,2,0,2
SANTA CRUZ DE LA SIERRA,mortalidad institucional,otras muertes en personas mayores de 5 anos,2005-07-01,1,21,0,0,1,21,22
SANTA ROSA,mortalidad institucional,otras muertes en personas mayores de 5 anos,2005-07-01,0,1,0,0,0,1,1
SANTIAGO DE MACHACA,mortalidad institucional,otras muertes en personas mayores de 5 anos,2005-07-01,0,0,1,0,1,0,1
SANTIVAÃ‘ES,mortalidad institucional,otras muertes en personas mayores de 5 anos,2005-07-01,0,0,1,0,1,0,1
SORACACHI,mortalidad institucional,otras muertes en personas mayores de 5 anos,2005-07-01,0,0,0,1,0,1,1
SORATA,mortalidad institucional,otras muertes en personas mayores de 5 anos,2005-07-01,0,0,0,1,0,1,1
SUCRE,mortalidad institucional,otras muertes en personas mayores de 5 anos,2005-07-01,18,18,0,1,18,19,37
TAPACARI,mortalidad institucional,otras muertes en personas mayores de 5 anos,2005-07-01,0,0,1,1,1,1,2
TARABUCO,mortalidad institucional,otras muertes en personas mayores de 5 anos,2005-07-01,0,1,5,3,5,4,9
TARIJA,mortalidad institucional,otras muertes en personas mayores de 5 anos,2005-07-01,21,16,3,0,24,16,40
TARVITA,mortalidad institucional,otras muertes en personas mayores de 5 anos,2005-07-01,0,0,0,1,0,1,1
TIQUIPAYA,mortalidad institucional,otras muertes en personas mayores de 5 anos,2005-07-01,0,0,0,1,0,1,1
TOMINA,mortalidad institucional,otras muertes en personas mayores de 5 anos,2005-07-01,0,0,3,4,3,4,7
TORO TORO,mortalidad institucional,otras muertes en personas mayores de 5 anos,2005-07-01,0,0,1,0,1,0,1
TRIGAL,mortalidad institucional,otras muertes en personas mayores de 5 anos,2005-07-01,0,0,0,1,0,1,1
TRINIDAD,mortalidad institucional,otras muertes en personas mayores de 5 anos,2005-07-01,7,8,3,1,10,9,19
TUPIZA,mortalidad institucional,otras muertes en personas mayores de 5 anos,2005-07-01,0,0,0,1,0,1,1
UMALA,mortalidad institucional,otras muertes en personas mayores de 5 anos,2005-07-01,0,0,1,0,1,0,1
UNCIA,mortalidad institucional,otras muertes en personas mayores de 5 anos,2005-07-01,2,3,0,1,2,4,6
UYUNI,mortalidad institucional,otras muertes en personas mayores de 5 anos,2005-07-01,0,0,5,2,5,2,7
VILA VILA,mortalidad institucional,otras muertes en personas mayores de 5 anos,2005-07-01,0,0,1,1,1,1,2
VILLA MONTES,mortalidad institucional,otras muertes en personas mayores de 5 anos,2005-07-01,1,0,0,1,1,1,2
VILLA RIVERO,mortalidad institucional,otras muertes en personas mayores de 5 anos,2005-07-01,0,0,1,1,1,1,2
VILLA SERRANO,mortalidad institucional,otras muertes en personas mayores de 5 anos,2005-07-01,0,0,3,1,3,1,4
VILLA TUNARI,mortalidad institucional,otras muertes en personas mayores de 5 anos,2005-07-01,1,0,1,3,2,3,5
VILLAZON,mortalidad institucional,otras muertes en personas mayores de 5 anos,2005-07-01,0,0,2,3,2,3,5
VITICHI,mortalidad institucional,otras muertes en personas mayores de 5 anos,2005-07-01,0,0,1,1,1,1,2
WARNES,mortalidad institucional,otras muertes en personas mayores de 5 anos,2005-07-01,0,0,1,1,1,1,2
YACUIBA,mortalidad institucional,otras muertes en personas mayores de 5 anos,2005-07-01,2,0,0,0,2,0,2
YAMPARAEZ,mortalidad institucional,otras muertes en personas mayores de 5 anos,2005-07-01,0,0,1,0,1,0,1
YAPACANI,mortalidad institucional,otras muertes en personas mayores de 5 anos,2005-07-01,0,0,2,1,2,1,3
YOTALA,mortalidad institucional,otras muertes en personas mayores de 5 anos,2005-07-01,0,0,2,1,2,1,3
ACACIO,mortalidad institucional,otras muertes en personas mayores de 5 anos,2005-08-01,0,0,1,0,1,0,1
ANCORAIMES,mortalidad institucional,otras muertes en personas mayores de 5 anos,2005-08-01,0,0,1,0,1,0,1
APOLO,mortalidad institucional,otras muertes en personas mayores de 5 anos,2005-08-01,0,1,1,1,1,2,3
ATOCHA,mortalidad institucional,otras muertes en personas mayores de 5 anos,2005-08-01,1,0,0,0,1,0,1
AYATA,mortalidad institucional,otras muertes en personas mayores de 5 anos,2005-08-01,0,0,0,1,0,1,1
AYOPAYA (V. DE INDEPENDENCIA),mortalidad institucional,otras muertes en personas mayores de 5 anos,2005-08-01,1,0,0,0,1,0,1
AZURDUY,mortalidad institucional,otras muertes en personas mayores de 5 anos,2005-08-01,0,0,2,0,2,0,2
BERMEJO,mortalidad institucional,otras muertes en personas mayores de 5 anos,2005-08-01,0,0,2,0,2,0,2
BETANZOS,mortalidad institucional,otras muertes en personas mayores de 5 anos,2005-08-01,0,0,1,4,1,4,5
BUENA VISTA,mortalidad institucional,otras muertes en personas mayores de 5 anos,2005-08-01,0,0,1,1,1,1,2
CABEZAS,mortalidad institucional,otras muertes en personas mayores de 5 anos,2005-08-01,3,0,0,0,3,0,3
"CAIZA ""D""",mortalidad institucional,otras muertes en personas mayores de 5 anos,2005-08-01,0,0,1,2,1,2,3
CAMARGO,mortalidad institucional,otras muertes en personas mayores de 5 anos,2005-08-01,0,0,0,1,0,1,1
CAMIRI,mortalidad institucional,otras muertes en personas mayores de 5 anos,2005-08-01,1,0,0,0,1,0,1
CARANAVI,mortalidad institucional,otras muertes en personas mayores de 5 anos,2005-08-01,2,0,6,2,8,2,10
CHARAGUA,mortalidad institucional,otras muertes en personas mayores de 5 anos,2005-08-01,1,1,0,0,1,1,2
CHULUMANI (V. DE LA LIBERTAD),mortalidad institucional,otras muertes en personas mayores de 5 anos,2005-08-01,0,1,1,1,1,2,3
COBIJA,mortalidad institucional,otras muertes en personas mayores de 5 anos,2005-08-01,0,0,0,1,0,1,1
COCHABAMBA,mortalidad institucional,otras muertes en personas mayores de 5 anos,2005-08-01,46,29,1,1,47,30,77
COLCAPIRHUA,mortalidad institucional,otras muertes en personas mayores de 5 anos,2005-08-01,1,0,0,0,1,0,1
COLOMI,mortalidad institucional,otras muertes en personas mayores de 5 anos,2005-08-01,0,0,1,1,1,1,2
COLQUECHACA,mortalidad institucional,otras muertes en personas mayores de 5 anos,2005-08-01,0,0,0,1,0,1,1
COMARAPA,mortalidad institucional,otras muertes en personas mayores de 5 anos,2005-08-01,0,1,0,0,0,1,1
COPACABANA,mortalidad institucional,otras muertes en personas mayores de 5 anos,2005-08-01,0,0,2,0,2,0,2
COROICO,mortalidad institucional,otras muertes en personas mayores de 5 anos,2005-08-01,1,0,0,1,1,1,2
COTAGAITA,mortalidad institucional,otras muertes en personas mayores de 5 anos,2005-08-01,0,0,0,1,0,1,1
COTOCA,mortalidad institucional,otras muertes en personas mayores de 5 anos,2005-08-01,0,1,1,2,1,3,4
CULPINA,mortalidad institucional,otras muertes en personas mayores de 5 anos,2005-08-01,1,0,0,3,1,3,4
DESAGUADERO,mortalidad institucional,otras muertes en personas mayores de 5 anos,2005-08-01,0,0,0,1,0,1,1
EL ALTO,mortalidad institucional,otras muertes en personas mayores de 5 anos,2005-08-01,7,8,2,4,9,12,21
EL PUENTE(STC),mortalidad institucional,otras muertes en personas mayores de 5 anos,2005-08-01,0,1,0,0,0,1,1
EL TORNO,mortalidad institucional,otras muertes en personas mayores de 5 anos,2005-08-01,0,0,1,0,1,0,1
EL VILLAR,mortalidad institucional,otras muertes en personas mayores de 5 anos,2005-08-01,0,0,1,0,1,0,1
EUCALIPTUS,mortalidad institucional,otras muertes en personas mayores de 5 anos,2005-08-01,0,0,2,0,2,0,2
FERNANDEZ ALONSO,mortalidad institucional,otras muertes en personas mayores de 5 anos,2005-08-01,0,1,1,0,1,1,2
GRAL. J.J. PEREZ (CHARAZANI),mortalidad institucional,otras muertes en personas mayores de 5 anos,2005-08-01,1,0,0,0,1,0,1
GUANAY,mortalidad institucional,otras muertes en personas mayores de 5 anos,2005-08-01,0,0,1,1,1,1,2
GUAYARAMERIN,mortalidad institucional,otras muertes en personas mayores de 5 anos,2005-08-01,1,1,0,0,1,1,2
HUANUNI,mortalidad institucional,otras muertes en personas mayores de 5 anos,2005-08-01,1,0,1,1,2,1,3
INGAVI (HUMAITA),mortalidad institucional,otras muertes en personas mayores de 5 anos,2005-08-01,0,0,1,0,1,0,1
LA ASUNTA,mortalidad institucional,otras muertes en personas mayores de 5 anos,2005-08-01,0,0,1,0,1,0,1
LA PAZ,mortalidad institucional,otras muertes en personas mayores de 5 anos,2005-08-01,90,73,12,8,102,81,183
LLALLAGUA,mortalidad institucional,otras muertes en personas mayores de 5 anos,2005-08-01,0,0,1,1,1,1,2
LORETO,mortalidad institucional,otras muertes en personas mayores de 5 anos,2005-08-01,0,0,1,2,1,2,3
MAGDALENA,mortalidad institucional,otras muertes en personas mayores de 5 anos,2005-08-01,0,2,0,1,0,3,3
MAIRANA,mortalidad institucional,otras muertes en personas mayores de 5 anos,2005-08-01,0,0,1,0,1,0,1
MINEROS,mortalidad institucional,otras muertes en personas mayores de 5 anos,2005-08-01,0,0,0,1,0,1,1
MIZQUE,mortalidad institucional,otras muertes en personas mayores de 5 anos,2005-08-01,1,0,1,2,2,2,4
MOCOMOCO,mortalidad institucional,otras muertes en personas mayores de 5 anos,2005-08-01,0,0,1,3,1,3,4
MONTEAGUDO,mortalidad institucional,otras muertes en personas mayores de 5 anos,2005-08-01,1,0,5,3,6,3,9
MONTERO,mortalidad institucional,otras muertes en personas mayores de 5 anos,2005-08-01,3,3,6,5,9,8,17
OCURI,mortalidad institucional,otras muertes en personas mayores de 5 anos,2005-08-01,0,0,0,1,0,1,1
ORURO,mortalidad institucional,otras muertes en personas mayores de 5 anos,2005-08-01,24,12,2,5,26,17,43
PADILLA,mortalidad institucional,otras muertes en personas mayores de 5 anos,2005-08-01,1,0,0,0,1,0,1
PALOS BLANCOS,mortalidad institucional,otras muertes en personas mayores de 5 anos,2005-08-01,0,0,3,0,3,0,3
PAPEL PAMPA,mortalidad institucional,otras muertes en personas mayores de 5 anos,2005-08-01,0,0,1,1,1,1,2
PATACAMAYA,mortalidad institucional,otras muertes en personas mayores de 5 anos,2005-08-01,0,0,3,1,3,1,4
PAZÃ‘A,mortalidad institucional,otras muertes en personas mayores de 5 anos,2005-08-01,0,0,0,1,0,1,1
POCONA,mortalidad institucional,otras muertes en personas mayores de 5 anos,2005-08-01,0,0,3,0,3,0,3
POOPO,mortalidad institucional,otras muertes en personas mayores de 5 anos,2005-08-01,0,0,1,0,1,0,1
PORTACHUELO,mortalidad institucional,otras muertes en personas mayores de 5 anos,2005-08-01,1,1,0,1,1,2,3
POSTRER VALLE,mortalidad institucional,otras muertes en personas mayores de 5 anos,2005-08-01,0,0,0,1,0,1,1
POTOSI,mortalidad institucional,otras muertes en personas mayores de 5 anos,2005-08-01,9,7,0,0,9,7,16
PRESTO,mortalidad institucional,otras muertes en personas mayores de 5 anos,2005-08-01,0,0,3,0,3,0,3
PUCARANI,mortalidad institucional,otras muertes en personas mayores de 5 anos,2005-08-01,0,1,0,0,0,1,1
PUERTO ACOSTA,mortalidad institucional,otras muertes en personas mayores de 5 anos,2005-08-01,0,0,0,4,0,4,4
PUERTO CARABUCO,mortalidad institucional,otras muertes en personas mayores de 5 anos,2005-08-01,0,0,1,1,1,1,2
PUERTO VILLARROEL,mortalidad institucional,otras muertes en personas mayores de 5 anos,2005-08-01,0,0,0,3,0,3,3
PUNA,mortalidad institucional,otras muertes en personas mayores de 5 anos,2005-08-01,0,0,0,1,0,1,1
PUNATA,mortalidad institucional,otras muertes en personas mayores de 5 anos,2005-08-01,3,0,7,6,10,6,16
QUILLACOLLO,mortalidad institucional,otras muertes en personas mayores de 5 anos,2005-08-01,0,1,0,0,0,1,1
REYES,mortalidad institucional,otras muertes en personas mayores de 5 anos,2005-08-01,1,0,0,0,1,0,1
RIBERALTA,mortalidad institucional,otras muertes en personas mayores de 5 anos,2005-08-01,6,4,2,0,8,4,12
SACABA,mortalidad institucional,otras muertes en personas mayores de 5 anos,2005-08-01,0,0,3,1,3,1,4
SAN AGUSTIN,mortalidad institucional,otras muertes en personas mayores de 5 anos,2005-08-01,0,0,0,1,0,1,1
SAN ANDRES,mortalidad institucional,otras muertes en personas mayores de 5 anos,2005-08-01,0,0,1,0,1,0,1
SAN BORJA,mortalidad institucional,otras muertes en personas mayores de 5 anos,2005-08-01,2,0,5,2,7,2,9
SAN IGNACIO,mortalidad institucional,otras muertes en personas mayores de 5 anos,2005-08-01,0,0,1,0,1,0,1
SAN IGNACIO DE VELASCO,mortalidad institucional,otras muertes en personas mayores de 5 anos,2005-08-01,0,0,3,1,3,1,4
SAN LORENZO(TJA),mortalidad institucional,otras muertes en personas mayores de 5 anos,2005-08-01,0,0,0,1,0,1,1
SAN LUCAS,mortalidad institucional,otras muertes en personas mayores de 5 anos,2005-08-01,0,0,7,6,7,6,13
SAN PEDRO,mortalidad institucional,otras muertes en personas mayores de 5 anos,2005-08-01,0,0,1,0,1,0,1
SAN PEDRO DE BUENA VISTA,mortalidad institucional,otras muertes en personas mayores de 5 anos,2005-08-01,0,0,0,1,0,1,1
SAN PEDRO DE TIQUINA,mortalidad institucional,otras muertes en personas mayores de 5 anos,2005-08-01,0,1,0,0,0,1,1
SANTA ANA,mortalidad institucional,otras muertes en personas mayores de 5 anos,2005-08-01,1,1,1,1,2,2,4
SANTA CRUZ DE LA SIERRA,mortalidad institucional,otras muertes en personas mayores de 5 anos,2005-08-01,9,5,0,0,9,5,14
SIPE SIPE,mortalidad institucional,otras muertes en personas mayores de 5 anos,2005-08-01,0,0,0,2,0,2,2
SOPACHUY,mortalidad institucional,otras muertes en personas mayores de 5 anos,2005-08-01,0,1,0,1,0,2,2
SORATA,mortalidad institucional,otras muertes en personas mayores de 5 anos,2005-08-01,0,0,1,0,1,0,1
SUCRE,mortalidad institucional,otras muertes en personas mayores de 5 anos,2005-08-01,19,26,1,1,20,27,47
TAPACARI,mortalidad institucional,otras muertes en personas mayores de 5 anos,2005-08-01,0,0,1,0,1,0,1
TARABUCO,mortalidad institucional,otras muertes en personas mayores de 5 anos,2005-08-01,0,0,0,5,0,5,5
TARIJA,mortalidad institucional,otras muertes en personas mayores de 5 anos,2005-08-01,19,15,7,2,26,17,43
TARVITA,mortalidad institucional,otras muertes en personas mayores de 5 anos,2005-08-01,0,1,2,3,2,4,6
TIPUANI,mortalidad institucional,otras muertes en personas mayores de 5 anos,2005-08-01,0,0,1,0,1,0,1
TIRAQUE (CBBA),mortalidad institucional,otras muertes en personas mayores de 5 anos,2005-08-01,0,0,1,1,1,1,2
TOCO,mortalidad institucional,otras muertes en personas mayores de 5 anos,2005-08-01,0,0,1,1,1,1,2
TOMINA,mortalidad institucional,otras muertes en personas mayores de 5 anos,2005-08-01,0,0,1,1,1,1,2
TOTORA(CBBA),mortalidad institucional,otras muertes en personas mayores de 5 anos,2005-08-01,0,1,0,0,0,1,1
TRINIDAD,mortalidad institucional,otras muertes en personas mayores de 5 anos,2005-08-01,2,7,5,0,7,7,14
TUPIZA,mortalidad institucional,otras muertes en personas mayores de 5 anos,2005-08-01,0,2,1,1,1,3,4
UNCIA,mortalidad institucional,otras muertes en personas mayores de 5 anos,2005-08-01,2,1,0,0,2,1,3
UYUNI,mortalidad institucional,otras muertes en personas mayores de 5 anos,2005-08-01,1,0,4,2,5,2,7
VACAS,mortalidad institucional,otras muertes en personas mayores de 5 anos,2005-08-01,0,0,0,1,0,1,1
VALLEGRANDE,mortalidad institucional,otras muertes en personas mayores de 5 anos,2005-08-01,1,0,0,0,1,0,1
VILLA MONTES,mortalidad institucional,otras muertes en personas mayores de 5 anos,2005-08-01,5,0,2,0,7,0,7
VILLA RIVERO,mortalidad institucional,otras muertes en personas mayores de 5 anos,2005-08-01,0,0,1,0,1,0,1
VILLA SERRANO,mortalidad institucional,otras muertes en personas mayores de 5 anos,2005-08-01,0,0,0,1,0,1,1
VILLA TUNARI,mortalidad institucional,otras muertes en personas mayores de 5 anos,2005-08-01,0,0,2,2,2,2,4
VILLA VACA GUZMAN (MUYUPAMPA),mortalidad institucional,otras muertes en personas mayores de 5 anos,2005-08-01,0,0,1,0,1,0,1
VILLAZON,mortalidad institucional,otras muertes en personas mayores de 5 anos,2005-08-01,1,1,1,1,2,2,4
WARNES,mortalidad institucional,otras muertes en personas mayores de 5 anos,2005-08-01,0,0,1,0,1,0,1
YACUIBA,mortalidad institucional,otras muertes en personas mayores de 5 anos,2005-08-01,4,2,0,0,4,2,6
YAMPARAEZ,mortalidad institucional,otras muertes en personas mayores de 5 anos,2005-08-01,0,0,1,2,1,2,3
YANACACHI,mortalidad institucional,otras muertes en personas mayores de 5 anos,2005-08-01,0,0,0,2,0,2,2
YAPACANI,mortalidad institucional,otras muertes en personas mayores de 5 anos,2005-08-01,0,1,0,0,0,1,1
YOTALA,mortalidad institucional,otras muertes en personas mayores de 5 anos,2005-08-01,0,0,2,0,2,0,2
ZUDAÃ‘EZ,mortalidad institucional,otras muertes en personas mayores de 5 anos,2005-08-01,0,0,0,1,0,1,1
ACHACACHI,mortalidad institucional,otras muertes en personas mayores de 5 anos,2005-09-01,0,0,2,1,2,1,3
ALCALA,mortalidad institucional,otras muertes en personas mayores de 5 anos,2005-09-01,0,0,2,0,2,0,2
ANZALDO,mortalidad institucional,otras muertes en personas mayores de 5 anos,2005-09-01,0,0,0,1,0,1,1
BELEN DE ANDAMARCA,mortalidad institucional,otras muertes en personas mayores de 5 anos,2005-09-01,1,0,0,0,1,0,1
BERMEJO,mortalidad institucional,otras muertes en personas mayores de 5 anos,2005-09-01,3,0,0,0,3,0,3
BETANZOS,mortalidad institucional,otras muertes en personas mayores de 5 anos,2005-09-01,1,1,6,5,7,6,13
BOLIVAR,mortalidad institucional,otras muertes en personas mayores de 5 anos,2005-09-01,0,0,0,1,0,1,1
"CAIZA ""D""",mortalidad institucional,otras muertes en personas mayores de 5 anos,2005-09-01,0,0,1,0,1,0,1
CAJUATA,mortalidad institucional,otras muertes en personas mayores de 5 anos,2005-09-01,0,0,0,2,0,2,2
CAMARGO,mortalidad institucional,otras muertes en personas mayores de 5 anos,2005-09-01,2,1,0,1,2,2,4
CAMIRI,mortalidad institucional,otras muertes en personas mayores de 5 anos,2005-09-01,2,0,0,0,2,0,2
CAPINOTA,mortalidad institucional,otras muertes en personas mayores de 5 anos,2005-09-01,0,0,0,1,0,1,1
CARANAVI,mortalidad institucional,otras muertes en personas mayores de 5 anos,2005-09-01,1,3,2,1,3,4,7
CHALLAPATA,mortalidad institucional,otras muertes en personas mayores de 5 anos,2005-09-01,0,0,7,0,7,0,7
CHAQUI,mortalidad institucional,otras muertes en personas mayores de 5 anos,2005-09-01,0,0,2,3,2,3,5
CHAYANTA,mortalidad institucional,otras muertes en personas mayores de 5 anos,2005-09-01,0,0,1,0,1,0,1
CHULUMANI (V. DE LA LIBERTAD),mortalidad institucional,otras muertes en personas mayores de 5 anos,2005-09-01,0,0,3,1,3,1,4
COBIJA,mortalidad institucional,otras muertes en personas mayores de 5 anos,2005-09-01,3,3,1,0,4,3,7
COCHABAMBA,mortalidad institucional,otras muertes en personas mayores de 5 anos,2005-09-01,46,24,1,4,47,28,75
COLCAPIRHUA,mortalidad institucional,otras muertes en personas mayores de 5 anos,2005-09-01,2,0,0,0,2,0,2
COLOMI,mortalidad institucional,otras muertes en personas mayores de 5 anos,2005-09-01,0,0,1,2,1,2,3
COLPA BELGICA,mortalidad institucional,otras muertes en personas mayores de 5 anos,2005-09-01,0,0,2,1,2,1,3
COMARAPA,mortalidad institucional,otras muertes en personas mayores de 5 anos,2005-09-01,0,1,0,0,0,1,1
COPACABANA,mortalidad institucional,otras muertes en personas mayores de 5 anos,2005-09-01,0,0,2,0,2,0,2
CORIPATA,mortalidad institucional,otras muertes en personas mayores de 5 anos,2005-09-01,0,1,1,0,1,1,2
COTAGAITA,mortalidad institucional,otras muertes en personas mayores de 5 anos,2005-09-01,0,0,2,1,2,1,3
COTOCA,mortalidad institucional,otras muertes en personas mayores de 5 anos,2005-09-01,0,1,0,1,0,2,2
CULPINA,mortalidad institucional,otras muertes en personas mayores de 5 anos,2005-09-01,0,0,2,2,2,2,4
CURAHUARA DE CARANGAS,mortalidad institucional,otras muertes en personas mayores de 5 anos,2005-09-01,0,0,3,0,3,0,3
EL ALTO,mortalidad institucional,otras muertes en personas mayores de 5 anos,2005-09-01,12,5,6,10,18,15,33
EL TORNO,mortalidad institucional,otras muertes en personas mayores de 5 anos,2005-09-01,0,0,0,1,0,1,1
FERNANDEZ ALONSO,mortalidad institucional,otras muertes en personas mayores de 5 anos,2005-09-01,1,0,2,0,3,0,3
FILADELFIA,mortalidad institucional,otras muertes en personas mayores de 5 anos,2005-09-01,0,0,0,1,0,1,1
GUAYARAMERIN,mortalidad institucional,otras muertes en personas mayores de 5 anos,2005-09-01,2,0,2,2,4,2,6
HUACARETA,mortalidad institucional,otras muertes en personas mayores de 5 anos,2005-09-01,0,0,2,2,2,2,4
HUANUNI,mortalidad institucional,otras muertes en personas mayores de 5 anos,2005-09-01,0,1,1,1,1,2,3
ICLA,mortalidad institucional,otras muertes en personas mayores de 5 anos,2005-09-01,0,0,1,1,1,1,2
INCAHUASI,mortalidad institucional,otras muertes en personas mayores de 5 anos,2005-09-01,0,0,0,1,0,1,1
IRUPANA (VILLA DE LANZA),mortalidad institucional,otras muertes en personas mayores de 5 anos,2005-09-01,0,0,0,2,0,2,2
LA PAZ,mortalidad institucional,otras muertes en personas mayores de 5 anos,2005-09-01,54,76,7,7,61,83,144
LLALLAGUA,mortalidad institucional,otras muertes en personas mayores de 5 anos,2005-09-01,1,1,1,0,2,1,3
LORETO,mortalidad institucional,otras muertes en personas mayores de 5 anos,2005-09-01,0,0,1,0,1,0,1
LURIBAY,mortalidad institucional,otras muertes en personas mayores de 5 anos,2005-09-01,0,0,0,2,0,2,2
MACHARETI,mortalidad institucional,otras muertes en personas mayores de 5 anos,2005-09-01,0,0,2,0,2,0,2
MAGDALENA,mortalidad institucional,otras muertes en personas mayores de 5 anos,2005-09-01,0,1,1,0,1,1,2
MINEROS,mortalidad institucional,otras muertes en personas mayores de 5 anos,2005-09-01,0,0,1,2,1,2,3
MOCOMOCO,mortalidad institucional,otras muertes en personas mayores de 5 anos,2005-09-01,0,0,0,3,0,3,3
MONTEAGUDO,mortalidad institucional,otras muertes en personas mayores de 5 anos,2005-09-01,2,0,0,3,2,3,5
MONTERO,mortalidad institucional,otras muertes en personas mayores de 5 anos,2005-09-01,0,0,3,3,3,3,6
OCURI,mortalidad institucional,otras muertes en personas mayores de 5 anos,2005-09-01,0,0,3,0,3,0,3
ORURO,mortalidad institucional,otras muertes en personas mayores de 5 anos,2005-09-01,12,16,1,3,13,19,32
PALOS BLANCOS,mortalidad institucional,otras muertes en personas mayores de 5 anos,2005-09-01,0,0,1,0,1,0,1
PAPEL PAMPA,mortalidad institucional,otras muertes en personas mayores de 5 anos,2005-09-01,0,0,0,2,0,2,2
PASORAPA,mortalidad institucional,otras muertes en personas mayores de 5 anos,2005-09-01,0,0,1,0,1,0,1
PATACAMAYA,mortalidad institucional,otras muertes en personas mayores de 5 anos,2005-09-01,0,0,2,0,2,0,2
PAZÃ‘A,mortalidad institucional,otras muertes en personas mayores de 5 anos,2005-09-01,0,0,1,1,1,1,2
POROMA,mortalidad institucional,otras muertes en personas mayores de 5 anos,2005-09-01,0,0,0,4,0,4,4
POTOSI,mortalidad institucional,otras muertes en personas mayores de 5 anos,2005-09-01,9,14,0,0,9,14,23
PRESTO,mortalidad institucional,otras muertes en personas mayores de 5 anos,2005-09-01,0,0,1,2,1,2,3
PUCARA,mortalidad institucional,otras muertes en personas mayores de 5 anos,2005-09-01,0,0,2,0,2,0,2
PUERTO ACOSTA,mortalidad institucional,otras muertes en personas mayores de 5 anos,2005-09-01,0,1,1,1,1,2,3
PUERTO CARABUCO,mortalidad institucional,otras muertes en personas mayores de 5 anos,2005-09-01,0,0,0,1,0,1,1
PUERTO RICO,mortalidad institucional,otras muertes en personas mayores de 5 anos,2005-09-01,0,0,1,0,1,0,1
PUERTO VILLARROEL,mortalidad institucional,otras muertes en personas mayores de 5 anos,2005-09-01,1,0,0,0,1,0,1
PUNA,mortalidad institucional,otras muertes en personas mayores de 5 anos,2005-09-01,0,0,1,1,1,1,2
PUNATA,mortalidad institucional,otras muertes en personas mayores de 5 anos,2005-09-01,0,0,3,0,3,0,3
QUILLACOLLO,mortalidad institucional,otras muertes en personas mayores de 5 anos,2005-09-01,1,0,0,0,1,0,1
RIBERALTA,mortalidad institucional,otras muertes en personas mayores de 5 anos,2005-09-01,2,1,4,1,6,2,8
SACABA,mortalidad institucional,otras muertes en personas mayores de 5 anos,2005-09-01,2,1,3,9,5,10,15
SAN ANDRES,mortalidad institucional,otras muertes en personas mayores de 5 anos,2005-09-01,0,0,1,0,1,0,1
SAN BORJA,mortalidad institucional,otras muertes en personas mayores de 5 anos,2005-09-01,1,2,2,1,3,3,6
SAN BUENA VENTURA,mortalidad institucional,otras muertes en personas mayores de 5 anos,2005-09-01,0,0,1,0,1,0,1
SAN CARLOS,mortalidad institucional,otras muertes en personas mayores de 5 anos,2005-09-01,0,0,1,1,1,1,2
SAN IGNACIO DE VELASCO,mortalidad institucional,otras muertes en personas mayores de 5 anos,2005-09-01,0,1,1,0,1,1,2
SAN JOAQUIN,mortalidad institucional,otras muertes en personas mayores de 5 anos,2005-09-01,1,2,0,0,1,2,3
SAN JUAN DE YAPACANI,mortalidad institucional,otras muertes en personas mayores de 5 anos,2005-09-01,1,0,0,0,1,0,1
SAN LORENZO(TJA),mortalidad institucional,otras muertes en personas mayores de 5 anos,2005-09-01,0,0,3,0,3,0,3
SAN LUCAS,mortalidad institucional,otras muertes en personas mayores de 5 anos,2005-09-01,1,1,3,7,4,8,12
SAN PABLO DE LIPEZ,mortalidad institucional,otras muertes en personas mayores de 5 anos,2005-09-01,0,0,0,1,0,1,1
SAN PEDRO,mortalidad institucional,otras muertes en personas mayores de 5 anos,2005-09-01,0,0,1,0,1,0,1
SAN PEDRO DE BUENA VISTA,mortalidad institucional,otras muertes en personas mayores de 5 anos,2005-09-01,0,0,1,0,1,0,1
SAN RAFAEL,mortalidad institucional,otras muertes en personas mayores de 5 anos,2005-09-01,0,0,1,0,1,0,1
SANTA ANA,mortalidad institucional,otras muertes en personas mayores de 5 anos,2005-09-01,0,2,0,0,0,2,2
SAPAHAQUI,mortalidad institucional,otras muertes en personas mayores de 5 anos,2005-09-01,0,0,1,0,1,0,1
SENA,mortalidad institucional,otras muertes en personas mayores de 5 anos,2005-09-01,0,0,1,0,1,0,1
SIPE SIPE,mortalidad institucional,otras muertes en personas mayores de 5 anos,2005-09-01,0,1,0,1,0,2,2
SOPACHUY,mortalidad institucional,otras muertes en personas mayores de 5 anos,2005-09-01,1,0,0,1,1,1,2
SORATA,mortalidad institucional,otras muertes en personas mayores de 5 anos,2005-09-01,0,0,1,0,1,0,1
SUCRE,mortalidad institucional,otras muertes en personas mayores de 5 anos,2005-09-01,16,17,2,3,18,20,38
TARABUCO,mortalidad institucional,otras muertes en personas mayores de 5 anos,2005-09-01,0,0,6,5,6,5,11
TARIJA,mortalidad institucional,otras muertes en personas mayores de 5 anos,2005-09-01,14,15,2,2,16,17,33
TARVITA,mortalidad institucional,otras muertes en personas mayores de 5 anos,2005-09-01,0,0,1,1,1,1,2
TEOPONTE,mortalidad institucional,otras muertes en personas mayores de 5 anos,2005-09-01,0,0,1,0,1,0,1
TIPUANI,mortalidad institucional,otras muertes en personas mayores de 5 anos,2005-09-01,0,0,1,0,1,0,1
TIRAQUE (CBBA),mortalidad institucional,otras muertes en personas mayores de 5 anos,2005-09-01,0,1,0,2,0,3,3
TOMINA,mortalidad institucional,otras muertes en personas mayores de 5 anos,2005-09-01,0,0,1,0,1,0,1
TORO TORO,mortalidad institucional,otras muertes en personas mayores de 5 anos,2005-09-01,0,0,1,1,1,1,2
TOTORA(ORR),mortalidad institucional,otras muertes en personas mayores de 5 anos,2005-09-01,1,0,0,0,1,0,1
TRIGAL,mortalidad institucional,otras muertes en personas mayores de 5 anos,2005-09-01,0,0,0,1,0,1,1
TRINIDAD,mortalidad institucional,otras muertes en personas mayores de 5 anos,2005-09-01,5,3,5,4,10,7,17
TUPIZA,mortalidad institucional,otras muertes en personas mayores de 5 anos,2005-09-01,0,0,1,4,1,4,5
UNCIA,mortalidad institucional,otras muertes en personas mayores de 5 anos,2005-09-01,3,0,0,1,3,1,4
UYUNI,mortalidad institucional,otras muertes en personas mayores de 5 anos,2005-09-01,0,0,1,1,1,1,2
VACAS,mortalidad institucional,otras muertes en personas mayores de 5 anos,2005-09-01,0,0,1,1,1,1,2
VALLEGRANDE,mortalidad institucional,otras muertes en personas mayores de 5 anos,2005-09-01,1,0,0,0,1,0,1
VILLA MONTES,mortalidad institucional,otras muertes en personas mayores de 5 anos,2005-09-01,0,0,3,0,3,0,3
VILLA RIVERO,mortalidad institucional,otras muertes en personas mayores de 5 anos,2005-09-01,0,0,0,1,0,1,1
VILLA TUNARI,mortalidad institucional,otras muertes en personas mayores de 5 anos,2005-09-01,0,0,2,1,2,1,3
VILLA VACA GUZMAN (MUYUPAMPA),mortalidad institucional,otras muertes en personas mayores de 5 anos,2005-09-01,0,0,0,1,0,1,1
VILLAZON,mortalidad institucional,otras muertes en personas mayores de 5 anos,2005-09-01,2,2,0,0,2,2,4
VINTO,mortalidad institucional,otras muertes en personas mayores de 5 anos,2005-09-01,0,0,1,4,1,4,5
WARNES,mortalidad institucional,otras muertes en personas mayores de 5 anos,2005-09-01,0,0,1,0,1,0,1
YACUIBA,mortalidad institucional,otras muertes en personas mayores de 5 anos,2005-09-01,7,4,0,0,7,4,11
YAPACANI,mortalidad institucional,otras muertes en personas mayores de 5 anos,2005-09-01,0,0,1,1,1,1,2
YOTALA,mortalidad institucional,otras muertes en personas mayores de 5 anos,2005-09-01,0,0,1,1,1,1,2
ANCORAIMES,mortalidad institucional,otras muertes en personas mayores de 5 anos,2005-10-01,0,0,0,2,0,2,2
ATOCHA,mortalidad institucional,otras muertes en personas mayores de 5 anos,2005-10-01,0,0,0,10,0,10,10
AYATA,mortalidad institucional,otras muertes en personas mayores de 5 anos,2005-10-01,0,0,0,1,0,1,1
AYOPAYA (V. DE INDEPENDENCIA),mortalidad institucional,otras muertes en personas mayores de 5 anos,2005-10-01,1,0,0,0,1,0,1
BELEN DE ANDAMARCA,mortalidad institucional,otras muertes en personas mayores de 5 anos,2005-10-01,0,0,1,0,1,0,1
BETANZOS,mortalidad institucional,otras muertes en personas mayores de 5 anos,2005-10-01,0,1,6,5,6,6,12
CABEZAS,mortalidad institucional,otras muertes en personas mayores de 5 anos,2005-10-01,1,0,0,0,1,0,1
"CAIZA ""D""",mortalidad institucional,otras muertes en personas mayores de 5 anos,2005-10-01,0,0,1,0,1,0,1
CAMIRI,mortalidad institucional,otras muertes en personas mayores de 5 anos,2005-10-01,4,4,0,0,4,4,8
CARANAVI,mortalidad institucional,otras muertes en personas mayores de 5 anos,2005-10-01,1,0,2,1,3,1,4
CARAPARI,mortalidad institucional,otras muertes en personas mayores de 5 anos,2005-10-01,0,1,0,0,0,1,1
CHALLAPATA,mortalidad institucional,otras muertes en personas mayores de 5 anos,2005-10-01,0,0,1,3,1,3,4
CHAQUI,mortalidad institucional,otras muertes en personas mayores de 5 anos,2005-10-01,0,0,0,1,0,1,1
CHARAGUA,mortalidad institucional,otras muertes en personas mayores de 5 anos,2005-10-01,1,0,1,1,2,1,3
CHARAÃ‘A,mortalidad institucional,otras muertes en personas mayores de 5 anos,2005-10-01,0,0,1,0,1,0,1
CHAYANTA,mortalidad institucional,otras muertes en personas mayores de 5 anos,2005-10-01,0,0,1,1,1,1,2
COCHABAMBA,mortalidad institucional,otras muertes en personas mayores de 5 anos,2005-10-01,46,23,1,3,47,26,73
COLCAPIRHUA,mortalidad institucional,otras muertes en personas mayores de 5 anos,2005-10-01,2,0,0,0,2,0,2
COLLANA,mortalidad institucional,otras muertes en personas mayores de 5 anos,2005-10-01,0,0,1,0,1,0,1
COLOMI,mortalidad institucional,otras muertes en personas mayores de 5 anos,2005-10-01,0,0,1,1,1,1,2
COLPA BELGICA,mortalidad institucional,otras muertes en personas mayores de 5 anos,2005-10-01,0,0,1,0,1,0,1
COMARAPA,mortalidad institucional,otras muertes en personas mayores de 5 anos,2005-10-01,0,1,0,0,0,1,1
COPACABANA,mortalidad institucional,otras muertes en personas mayores de 5 anos,2005-10-01,0,0,3,1,3,1,4
COROICO,mortalidad institucional,otras muertes en personas mayores de 5 anos,2005-10-01,2,1,1,0,3,1,4
CORQUE,mortalidad institucional,otras muertes en personas mayores de 5 anos,2005-10-01,0,0,0,1,0,1,1
COTOCA,mortalidad institucional,otras muertes en personas mayores de 5 anos,2005-10-01,0,0,1,0,1,0,1
EL ALTO,mortalidad institucional,otras muertes en personas mayores de 5 anos,2005-10-01,8,8,2,5,10,13,23
EL PUENTE(STC),mortalidad institucional,otras muertes en personas mayores de 5 anos,2005-10-01,1,0,0,0,1,0,1
EL TORNO,mortalidad institucional,otras muertes en personas mayores de 5 anos,2005-10-01,0,0,0,2,0,2,2
EUCALIPTUS,mortalidad institucional,otras muertes en personas mayores de 5 anos,2005-10-01,0,0,0,1,0,1,1
FERNANDEZ ALONSO,mortalidad institucional,otras muertes en personas mayores de 5 anos,2005-10-01,0,0,0,1,0,1,1
GUANAY,mortalidad institucional,otras muertes en personas mayores de 5 anos,2005-10-01,0,0,1,2,1,2,3
GUAYARAMERIN,mortalidad institucional,otras muertes en personas mayores de 5 anos,2005-10-01,2,0,0,0,2,0,2
HUACARETA,mortalidad institucional,otras muertes en personas mayores de 5 anos,2005-10-01,0,0,0,1,0,1,1
INCAHUASI,mortalidad institucional,otras muertes en personas mayores de 5 anos,2005-10-01,0,0,1,0,1,0,1
IXIAMAS,mortalidad institucional,otras muertes en personas mayores de 5 anos,2005-10-01,0,1,0,0,0,1,1
LA GUARDIA,mortalidad institucional,otras muertes en personas mayores de 5 anos,2005-10-01,0,0,1,0,1,0,1
LA PAZ,mortalidad institucional,otras muertes en personas mayores de 5 anos,2005-10-01,68,91,13,17,81,108,189
LLALLAGUA,mortalidad institucional,otras muertes en personas mayores de 5 anos,2005-10-01,4,1,3,5,7,6,13
LORETO,mortalidad institucional,otras muertes en personas mayores de 5 anos,2005-10-01,0,0,1,0,1,0,1
MACHARETI,mortalidad institucional,otras muertes en personas mayores de 5 anos,2005-10-01,0,0,2,1,2,1,3
MIZQUE,mortalidad institucional,otras muertes en personas mayores de 5 anos,2005-10-01,0,0,0,2,0,2,2
MOCOMOCO,mortalidad institucional,otras muertes en personas mayores de 5 anos,2005-10-01,0,0,2,4,2,4,6
MONTEAGUDO,mortalidad institucional,otras muertes en personas mayores de 5 anos,2005-10-01,1,1,2,4,3,5,8
MONTERO,mortalidad institucional,otras muertes en personas mayores de 5 anos,2005-10-01,0,0,3,2,3,2,5
OCURI,mortalidad institucional,otras muertes en personas mayores de 5 anos,2005-10-01,0,0,1,1,1,1,2
ORURO,mortalidad institucional,otras muertes en personas mayores de 5 anos,2005-10-01,27,7,2,3,29,10,39
PALOS BLANCOS,mortalidad institucional,otras muertes en personas mayores de 5 anos,2005-10-01,1,0,0,1,1,1,2
PORTACHUELO,mortalidad institucional,otras muertes en personas mayores de 5 anos,2005-10-01,0,0,0,1,0,1,1
POSTRER VALLE,mortalidad institucional,otras muertes en personas mayores de 5 anos,2005-10-01,0,0,1,0,1,0,1
POTOSI,mortalidad institucional,otras muertes en personas mayores de 5 anos,2005-10-01,11,7,1,3,12,10,22
PRESTO,mortalidad institucional,otras muertes en personas mayores de 5 anos,2005-10-01,0,0,4,1,4,1,5
PUERTO ACOSTA,mortalidad institucional,otras muertes en personas mayores de 5 anos,2005-10-01,0,0,1,1,1,1,2
PUERTO VILLARROEL,mortalidad institucional,otras muertes en personas mayores de 5 anos,2005-10-01,1,1,0,2,1,3,4
PUNA,mortalidad institucional,otras muertes en personas mayores de 5 anos,2005-10-01,0,0,1,0,1,0,1
PUNATA,mortalidad institucional,otras muertes en personas mayores de 5 anos,2005-10-01,1,0,8,5,9,5,14
QUILLACOLLO,mortalidad institucional,otras muertes en personas mayores de 5 anos,2005-10-01,0,0,1,1,1,1,2
RAVELO,mortalidad institucional,otras muertes en personas mayores de 5 anos,2005-10-01,0,0,1,0,1,0,1
RIBERALTA,mortalidad institucional,otras muertes en personas mayores de 5 anos,2005-10-01,1,3,4,2,5,5,10
ROBORE,mortalidad institucional,otras muertes en personas mayores de 5 anos,2005-10-01,0,0,1,0,1,0,1
RURRENABAQUE,mortalidad institucional,otras muertes en personas mayores de 5 anos,2005-10-01,0,0,0,1,0,1,1
SACABA,mortalidad institucional,otras muertes en personas mayores de 5 anos,2005-10-01,1,1,8,6,9,7,16
SAMAIPATA,mortalidad institucional,otras muertes en personas mayores de 5 anos,2005-10-01,0,0,2,0,2,0,2
SAN ANDRES,mortalidad institucional,otras muertes en personas mayores de 5 anos,2005-10-01,0,0,1,0,1,0,1
SAN BENITO,mortalidad institucional,otras muertes en personas mayores de 5 anos,2005-10-01,0,0,0,2,0,2,2
SAN BORJA,mortalidad institucional,otras muertes en personas mayores de 5 anos,2005-10-01,0,1,2,0,2,1,3
SAN CARLOS,mortalidad institucional,otras muertes en personas mayores de 5 anos,2005-10-01,0,0,1,1,1,1,2
SAN JUAN DE YAPACANI,mortalidad institucional,otras muertes en personas mayores de 5 anos,2005-10-01,1,0,1,0,2,0,2
SAN LUCAS,mortalidad institucional,otras muertes en personas mayores de 5 anos,2005-10-01,1,1,2,0,3,1,4
SAN MIGUEL DE VELASCO,mortalidad institucional,otras muertes en personas mayores de 5 anos,2005-10-01,0,0,2,1,2,1,3
SAN PEDRO DE BUENA VISTA,mortalidad institucional,otras muertes en personas mayores de 5 anos,2005-10-01,0,0,2,0,2,0,2
SAN PEDRO DE CURAHUARA,mortalidad institucional,otras muertes en personas mayores de 5 anos,2005-10-01,0,0,0,1,0,1,1
SAN RAFAEL,mortalidad institucional,otras muertes en personas mayores de 5 anos,2005-10-01,0,0,0,1,0,1,1
SANTA ANA,mortalidad institucional,otras muertes en personas mayores de 5 anos,2005-10-01,1,0,0,0,1,0,1
SANTA CRUZ DE LA SIERRA,mortalidad institucional,otras muertes en personas mayores de 5 anos,2005-10-01,9,6,1,0,10,6,16
SAPAHAQUI,mortalidad institucional,otras muertes en personas mayores de 5 anos,2005-10-01,0,0,1,0,1,0,1
SENA,mortalidad institucional,otras muertes en personas mayores de 5 anos,2005-10-01,0,0,1,0,1,0,1
SIPE SIPE,mortalidad institucional,otras muertes en personas mayores de 5 anos,2005-10-01,0,0,3,1,3,1,4
SOPACHUY,mortalidad institucional,otras muertes en personas mayores de 5 anos,2005-10-01,0,0,0,1,0,1,1
SUCRE,mortalidad institucional,otras muertes en personas mayores de 5 anos,2005-10-01,22,10,0,1,22,11,33
TAPACARI,mortalidad institucional,otras muertes en personas mayores de 5 anos,2005-10-01,0,0,0,1,0,1,1
TARABUCO,mortalidad institucional,otras muertes en personas mayores de 5 anos,2005-10-01,0,0,2,1,2,1,3
TARIJA,mortalidad institucional,otras muertes en personas mayores de 5 anos,2005-10-01,18,19,4,3,22,22,44
TITO YUPANQUI (PARQUIPUJIO),mortalidad institucional,otras muertes en personas mayores de 5 anos,2005-10-01,0,0,0,1,0,1,1
TOMAVE,mortalidad institucional,otras muertes en personas mayores de 5 anos,2005-10-01,0,0,1,0,1,0,1
TOMINA,mortalidad institucional,otras muertes en personas mayores de 5 anos,2005-10-01,0,0,0,2,0,2,2
TRIGAL,mortalidad institucional,otras muertes en personas mayores de 5 anos,2005-10-01,0,0,1,0,1,0,1
TRINIDAD,mortalidad institucional,otras muertes en personas mayores de 5 anos,2005-10-01,6,7,0,2,6,9,15
TUPIZA,mortalidad institucional,otras muertes en personas mayores de 5 anos,2005-10-01,3,1,0,0,3,1,4
UNCIA,mortalidad institucional,otras muertes en personas mayores de 5 anos,2005-10-01,5,0,0,0,5,0,5
UYUNI,mortalidad institucional,otras muertes en personas mayores de 5 anos,2005-10-01,0,0,3,1,3,1,4
VILLA MONTES,mortalidad institucional,otras muertes en personas mayores de 5 anos,2005-10-01,4,2,1,0,5,2,7
VILLA RIVERO,mortalidad institucional,otras muertes en personas mayores de 5 anos,2005-10-01,0,0,1,3,1,3,4
VILLA SERRANO,mortalidad institucional,otras muertes en personas mayores de 5 anos,2005-10-01,0,0,1,2,1,2,3
VILLA TUNARI,mortalidad institucional,otras muertes en personas mayores de 5 anos,2005-10-01,0,0,4,3,4,3,7
VILLA VACA GUZMAN (MUYUPAMPA),mortalidad institucional,otras muertes en personas mayores de 5 anos,2005-10-01,1,0,3,2,4,2,6
VILLAZON,mortalidad institucional,otras muertes en personas mayores de 5 anos,2005-10-01,0,3,1,2,1,5,6
YACUIBA,mortalidad institucional,otras muertes en personas mayores de 5 anos,2005-10-01,6,5,1,1,7,6,13
YAMPARAEZ,mortalidad institucional,otras muertes en personas mayores de 5 anos,2005-10-01,0,0,0,1,0,1,1
YAPACANI,mortalidad institucional,otras muertes en personas mayores de 5 anos,2005-10-01,1,0,2,0,3,0,3
YOTALA,mortalidad institucional,otras muertes en personas mayores de 5 anos,2005-10-01,0,0,1,1,1,1,2
ZUDAÃ‘EZ,mortalidad institucional,otras muertes en personas mayores de 5 anos,2005-10-01,0,0,1,0,1,0,1
ALALAY,mortalidad institucional,otras muertes en personas mayores de 5 anos,2005-11-01,0,0,0,1,0,1,1
ANCORAIMES,mortalidad institucional,otras muertes en personas mayores de 5 anos,2005-11-01,0,0,1,0,1,0,1
ARBIETO,mortalidad institucional,otras muertes en personas mayores de 5 anos,2005-11-01,0,0,0,1,0,1,1
ARQUE,mortalidad institucional,otras muertes en personas mayores de 5 anos,2005-11-01,0,0,1,0,1,0,1
AZURDUY,mortalidad institucional,otras muertes en personas mayores de 5 anos,2005-11-01,0,0,1,0,1,0,1
BETANZOS,mortalidad institucional,otras muertes en personas mayores de 5 anos,2005-11-01,0,0,8,3,8,3,11
"CAIZA ""D""",mortalidad institucional,otras muertes en personas mayores de 5 anos,2005-11-01,0,0,0,3,0,3,3
CAJUATA,mortalidad institucional,otras muertes en personas mayores de 5 anos,2005-11-01,0,1,0,0,0,1,1
CALAMARCA,mortalidad institucional,otras muertes en personas mayores de 5 anos,2005-11-01,0,0,2,0,2,0,2
CAMARGO,mortalidad institucional,otras muertes en personas mayores de 5 anos,2005-11-01,0,0,1,1,1,1,2
CAMIRI,mortalidad institucional,otras muertes en personas mayores de 5 anos,2005-11-01,6,4,1,0,7,4,11
CARANAVI,mortalidad institucional,otras muertes en personas mayores de 5 anos,2005-11-01,3,0,1,2,4,2,6
CHALLAPATA,mortalidad institucional,otras muertes en personas mayores de 5 anos,2005-11-01,0,0,1,6,1,6,7
CHAQUI,mortalidad institucional,otras muertes en personas mayores de 5 anos,2005-11-01,0,0,1,2,1,2,3
CHULUMANI (V. DE LA LIBERTAD),mortalidad institucional,otras muertes en personas mayores de 5 anos,2005-11-01,0,2,2,0,2,2,4
COBIJA,mortalidad institucional,otras muertes en personas mayores de 5 anos,2005-11-01,1,1,0,0,1,1,2
COCHABAMBA,mortalidad institucional,otras muertes en personas mayores de 5 anos,2005-11-01,52,42,0,5,52,47,99
COPACABANA,mortalidad institucional,otras muertes en personas mayores de 5 anos,2005-11-01,0,0,1,1,1,1,2
CORO CORO,mortalidad institucional,otras muertes en personas mayores de 5 anos,2005-11-01,0,0,0,2,0,2,2
COROICO,mortalidad institucional,otras muertes en personas mayores de 5 anos,2005-11-01,0,0,1,0,1,0,1
CORQUE,mortalidad institucional,otras muertes en personas mayores de 5 anos,2005-11-01,0,0,1,0,1,0,1
COTAGAITA,mortalidad institucional,otras muertes en personas mayores de 5 anos,2005-11-01,0,0,1,2,1,2,3
COTOCA,mortalidad institucional,otras muertes en personas mayores de 5 anos,2005-11-01,0,0,3,0,3,0,3
CUATRO CAÃ‘ADAS,mortalidad institucional,otras muertes en personas mayores de 5 anos,2005-11-01,0,0,0,1,0,1,1
CULPINA,mortalidad institucional,otras muertes en personas mayores de 5 anos,2005-11-01,0,0,1,0,1,0,1
CURAHUARA DE CARANGAS,mortalidad institucional,otras muertes en personas mayores de 5 anos,2005-11-01,0,0,1,0,1,0,1
DESAGUADERO,mortalidad institucional,otras muertes en personas mayores de 5 anos,2005-11-01,0,0,2,0,2,0,2
EL ALTO,mortalidad institucional,otras muertes en personas mayores de 5 anos,2005-11-01,4,3,6,5,10,8,18
EUCALIPTUS,mortalidad institucional,otras muertes en personas mayores de 5 anos,2005-11-01,0,0,2,1,2,1,3
GUANAY,mortalidad institucional,otras muertes en personas mayores de 5 anos,2005-11-01,0,0,0,1,0,1,1
HUANUNI,mortalidad institucional,otras muertes en personas mayores de 5 anos,2005-11-01,0,0,0,1,0,1,1
ICLA,mortalidad institucional,otras muertes en personas mayores de 5 anos,2005-11-01,0,0,0,1,0,1,1
IRUPANA (VILLA DE LANZA),mortalidad institucional,otras muertes en personas mayores de 5 anos,2005-11-01,1,0,1,0,2,0,2
IXIAMAS,mortalidad institucional,otras muertes en personas mayores de 5 anos,2005-11-01,0,1,0,0,0,1,1
LA PAZ,mortalidad institucional,otras muertes en personas mayores de 5 anos,2005-11-01,59,76,9,8,68,84,152
LAGUNILLAS,mortalidad institucional,otras muertes en personas mayores de 5 anos,2005-11-01,1,0,0,0,1,0,1
LLALLAGUA,mortalidad institucional,otras muertes en personas mayores de 5 anos,2005-11-01,0,1,5,7,5,8,13
LORETO,mortalidad institucional,otras muertes en personas mayores de 5 anos,2005-11-01,0,0,1,0,1,0,1
LURIBAY,mortalidad institucional,otras muertes en personas mayores de 5 anos,2005-11-01,0,1,0,0,0,1,1
MACHARETI,mortalidad institucional,otras muertes en personas mayores de 5 anos,2005-11-01,0,0,1,1,1,1,2
MAGDALENA,mortalidad institucional,otras muertes en personas mayores de 5 anos,2005-11-01,0,0,1,0,1,0,1
MINEROS,mortalidad institucional,otras muertes en personas mayores de 5 anos,2005-11-01,1,0,0,0,1,0,1
MIZQUE,mortalidad institucional,otras muertes en personas mayores de 5 anos,2005-11-01,0,0,0,3,0,3,3
MOCOMOCO,mortalidad institucional,otras muertes en personas mayores de 5 anos,2005-11-01,0,0,2,3,2,3,5
MONTEAGUDO,mortalidad institucional,otras muertes en personas mayores de 5 anos,2005-11-01,3,0,1,3,4,3,7
MONTERO,mortalidad institucional,otras muertes en personas mayores de 5 anos,2005-11-01,2,3,3,0,5,3,8
OCURI,mortalidad institucional,otras muertes en personas mayores de 5 anos,2005-11-01,0,0,1,1,1,1,2
ORURO,mortalidad institucional,otras muertes en personas mayores de 5 anos,2005-11-01,19,19,3,2,22,21,43
PADILLA,mortalidad institucional,otras muertes en personas mayores de 5 anos,2005-11-01,0,0,1,3,1,3,4
PALOS BLANCOS,mortalidad institucional,otras muertes en personas mayores de 5 anos,2005-11-01,0,0,1,1,1,1,2
PATACAMAYA,mortalidad institucional,otras muertes en personas mayores de 5 anos,2005-11-01,0,0,0,1,0,1,1
PAZÃ‘A,mortalidad institucional,otras muertes en personas mayores de 5 anos,2005-11-01,0,0,1,0,1,0,1
POROMA,mortalidad institucional,otras muertes en personas mayores de 5 anos,2005-11-01,0,0,1,0,1,0,1
PORTACHUELO,mortalidad institucional,otras muertes en personas mayores de 5 anos,2005-11-01,0,1,1,0,1,1,2
POTOSI,mortalidad institucional,otras muertes en personas mayores de 5 anos,2005-11-01,15,14,7,0,22,14,36
PRESTO,mortalidad institucional,otras muertes en personas mayores de 5 anos,2005-11-01,0,0,4,1,4,1,5
PUERTO CARABUCO,mortalidad institucional,otras muertes en personas mayores de 5 anos,2005-11-01,0,0,0,2,0,2,2
PUERTO GONZALO MORENO,mortalidad institucional,otras muertes en personas mayores de 5 anos,2005-11-01,0,0,1,0,1,0,1
PUERTO VILLARROEL,mortalidad institucional,otras muertes en personas mayores de 5 anos,2005-11-01,0,1,1,0,1,1,2
PUNA,mortalidad institucional,otras muertes en personas mayores de 5 anos,2005-11-01,0,0,1,1,1,1,2
PUNATA,mortalidad institucional,otras muertes en personas mayores de 5 anos,2005-11-01,0,0,3,7,3,7,10
QUILLACOLLO,mortalidad institucional,otras muertes en personas mayores de 5 anos,2005-11-01,0,0,3,2,3,2,5
RIBERALTA,mortalidad institucional,otras muertes en personas mayores de 5 anos,2005-11-01,0,0,2,3,2,3,5
RURRENABAQUE,mortalidad institucional,otras muertes en personas mayores de 5 anos,2005-11-01,1,2,0,0,1,2,3
SACABA,mortalidad institucional,otras muertes en personas mayores de 5 anos,2005-11-01,0,1,5,8,5,9,14
SAMAIPATA,mortalidad institucional,otras muertes en personas mayores de 5 anos,2005-11-01,0,0,1,0,1,0,1
SAN ANDRES,mortalidad institucional,otras muertes en personas mayores de 5 anos,2005-11-01,0,0,0,1,0,1,1
SAN BORJA,mortalidad institucional,otras muertes en personas mayores de 5 anos,2005-11-01,0,0,4,1,4,1,5
SAN CARLOS,mortalidad institucional,otras muertes en personas mayores de 5 anos,2005-11-01,0,1,0,0,0,1,1
SAN IGNACIO DE VELASCO,mortalidad institucional,otras muertes en personas mayores de 5 anos,2005-11-01,1,2,1,3,2,5,7
SAN JUAN DE YAPACANI,mortalidad institucional,otras muertes en personas mayores de 5 anos,2005-11-01,0,0,1,0,1,0,1
SAN JULIAN,mortalidad institucional,otras muertes en personas mayores de 5 anos,2005-11-01,0,0,1,0,1,0,1
SAN LUCAS,mortalidad institucional,otras muertes en personas mayores de 5 anos,2005-11-01,0,0,4,5,4,5,9
SAN MIGUEL DE VELASCO,mortalidad institucional,otras muertes en personas mayores de 5 anos,2005-11-01,1,0,0,1,1,1,2
SAN PEDRO DE BUENA VISTA,mortalidad institucional,otras muertes en personas mayores de 5 anos,2005-11-01,0,0,4,0,4,0,4
SAN RAFAEL,mortalidad institucional,otras muertes en personas mayores de 5 anos,2005-11-01,0,0,2,0,2,0,2
SANTA ANA,mortalidad institucional,otras muertes en personas mayores de 5 anos,2005-11-01,2,0,0,0,2,0,2
SANTA CRUZ DE LA SIERRA,mortalidad institucional,otras muertes en personas mayores de 5 anos,2005-11-01,8,6,1,1,9,7,16
SOPACHUY,mortalidad institucional,otras muertes en personas mayores de 5 anos,2005-11-01,0,0,1,0,1,0,1
SORATA,mortalidad institucional,otras muertes en personas mayores de 5 anos,2005-11-01,0,0,1,0,1,0,1
SUCRE,mortalidad institucional,otras muertes en personas mayores de 5 anos,2005-11-01,17,16,1,1,18,17,35
TAPACARI,mortalidad institucional,otras muertes en personas mayores de 5 anos,2005-11-01,0,0,0,2,0,2,2
TARABUCO,mortalidad institucional,otras muertes en personas mayores de 5 anos,2005-11-01,0,0,3,2,3,2,5
TARIJA,mortalidad institucional,otras muertes en personas mayores de 5 anos,2005-11-01,21,13,5,2,26,15,41
TARVITA,mortalidad institucional,otras muertes en personas mayores de 5 anos,2005-11-01,0,0,0,1,0,1,1
TOMINA,mortalidad institucional,otras muertes en personas mayores de 5 anos,2005-11-01,0,0,0,1,0,1,1
TOTORA(CBBA),mortalidad institucional,otras muertes en personas mayores de 5 anos,2005-11-01,1,0,0,0,1,0,1
TRIGAL,mortalidad institucional,otras muertes en personas mayores de 5 anos,2005-11-01,0,0,1,0,1,0,1
TRINIDAD,mortalidad institucional,otras muertes en personas mayores de 5 anos,2005-11-01,5,6,2,6,7,12,19
TUPIZA,mortalidad institucional,otras muertes en personas mayores de 5 anos,2005-11-01,1,0,1,1,2,1,3
UNCIA,mortalidad institucional,otras muertes en personas mayores de 5 anos,2005-11-01,0,5,0,0,0,5,5
UYUNI,mortalidad institucional,otras muertes en personas mayores de 5 anos,2005-11-01,0,0,1,2,1,2,3
VALLEGRANDE,mortalidad institucional,otras muertes en personas mayores de 5 anos,2005-11-01,3,0,0,0,3,0,3
VILA VILA,mortalidad institucional,otras muertes en personas mayores de 5 anos,2005-11-01,0,0,2,2,2,2,4
VILLA MONTES,mortalidad institucional,otras muertes en personas mayores de 5 anos,2005-11-01,4,0,5,1,9,1,10
VILLA SERRANO,mortalidad institucional,otras muertes en personas mayores de 5 anos,2005-11-01,0,0,0,2,0,2,2
VILLA TUNARI,mortalidad institucional,otras muertes en personas mayores de 5 anos,2005-11-01,0,0,2,1,2,1,3
VILLAZON,mortalidad institucional,otras muertes en personas mayores de 5 anos,2005-11-01,1,0,2,0,3,0,3
VITICHI,mortalidad institucional,otras muertes en personas mayores de 5 anos,2005-11-01,0,0,1,0,1,0,1
WARNES,mortalidad institucional,otras muertes en personas mayores de 5 anos,2005-11-01,0,0,1,0,1,0,1
YACUIBA,mortalidad institucional,otras muertes en personas mayores de 5 anos,2005-11-01,3,1,2,0,5,1,6
YAPACANI,mortalidad institucional,otras muertes en personas mayores de 5 anos,2005-11-01,1,0,1,0,2,0,2
YOTALA,mortalidad institucional,otras muertes en personas mayores de 5 anos,2005-11-01,0,0,1,0,1,0,1
ACHACACHI,mortalidad institucional,otras muertes en personas mayores de 5 anos,2005-12-01,0,0,0,3,0,3,3
ALALAY,mortalidad institucional,otras muertes en personas mayores de 5 anos,2005-12-01,0,0,0,1,0,1,1
AZURDUY,mortalidad institucional,otras muertes en personas mayores de 5 anos,2005-12-01,0,0,1,0,1,0,1
BETANZOS,mortalidad institucional,otras muertes en personas mayores de 5 anos,2005-12-01,0,0,5,1,5,1,6
BUENA VISTA,mortalidad institucional,otras muertes en personas mayores de 5 anos,2005-12-01,1,0,1,1,2,1,3
CABEZAS,mortalidad institucional,otras muertes en personas mayores de 5 anos,2005-12-01,1,0,0,0,1,0,1
CAIROMA,mortalidad institucional,otras muertes en personas mayores de 5 anos,2005-12-01,0,0,3,8,3,8,11
CAMIRI,mortalidad institucional,otras muertes en personas mayores de 5 anos,2005-12-01,1,2,0,0,1,2,3
CAPINOTA,mortalidad institucional,otras muertes en personas mayores de 5 anos,2005-12-01,1,0,0,0,1,0,1
CARANAVI,mortalidad institucional,otras muertes en personas mayores de 5 anos,2005-12-01,1,0,2,1,3,1,4
CHALLAPATA,mortalidad institucional,otras muertes en personas mayores de 5 anos,2005-12-01,0,0,5,2,5,2,7
CHAQUI,mortalidad institucional,otras muertes en personas mayores de 5 anos,2005-12-01,0,0,0,2,0,2,2
CHARAGUA,mortalidad institucional,otras muertes en personas mayores de 5 anos,2005-12-01,0,1,0,0,0,1,1
CHULUMANI (V. DE LA LIBERTAD),mortalidad institucional,otras muertes en personas mayores de 5 anos,2005-12-01,2,0,0,0,2,0,2
CHUMA,mortalidad institucional,otras muertes en personas mayores de 5 anos,2005-12-01,0,0,2,0,2,0,2
COCHABAMBA,mortalidad institucional,otras muertes en personas mayores de 5 anos,2005-12-01,45,43,3,0,48,43,91
"COLCHA ""K""",mortalidad institucional,otras muertes en personas mayores de 5 anos,2005-12-01,0,0,0,1,0,1,1
COROICO,mortalidad institucional,otras muertes en personas mayores de 5 anos,2005-12-01,2,0,0,0,2,0,2
CORQUE,mortalidad institucional,otras muertes en personas mayores de 5 anos,2005-12-01,0,0,3,0,3,0,3
COTAGAITA,mortalidad institucional,otras muertes en personas mayores de 5 anos,2005-12-01,0,0,1,1,1,1,2
COTOCA,mortalidad institucional,otras muertes en personas mayores de 5 anos,2005-12-01,0,0,0,1,0,1,1
CULPINA,mortalidad institucional,otras muertes en personas mayores de 5 anos,2005-12-01,0,1,2,0,2,1,3
EL ALTO,mortalidad institucional,otras muertes en personas mayores de 5 anos,2005-12-01,2,4,7,4,9,8,17
EL TORNO,mortalidad institucional,otras muertes en personas mayores de 5 anos,2005-12-01,0,0,0,1,0,1,1
FERNANDEZ ALONSO,mortalidad institucional,otras muertes en personas mayores de 5 anos,2005-12-01,1,0,1,1,2,1,3
GUAYARAMERIN,mortalidad institucional,otras muertes en personas mayores de 5 anos,2005-12-01,2,0,0,0,2,0,2
HUANUNI,mortalidad institucional,otras muertes en personas mayores de 5 anos,2005-12-01,0,0,0,1,0,1,1
IRUPANA (VILLA DE LANZA),mortalidad institucional,otras muertes en personas mayores de 5 anos,2005-12-01,1,0,1,4,2,4,6
LA ASUNTA,mortalidad institucional,otras muertes en personas mayores de 5 anos,2005-12-01,1,1,0,0,1,1,2
LA GUARDIA,mortalidad institucional,otras muertes en personas mayores de 5 anos,2005-12-01,0,0,2,0,2,0,2
LA PAZ,mortalidad institucional,otras muertes en personas mayores de 5 anos,2005-12-01,69,68,7,13,76,81,157
LAJA,mortalidad institucional,otras muertes en personas mayores de 5 anos,2005-12-01,0,0,2,1,2,1,3
LLALLAGUA,mortalidad institucional,otras muertes en personas mayores de 5 anos,2005-12-01,0,1,2,1,2,2,4
MACHARETI,mortalidad institucional,otras muertes en personas mayores de 5 anos,2005-12-01,0,0,0,1,0,1,1
MAGDALENA,mortalidad institucional,otras muertes en personas mayores de 5 anos,2005-12-01,0,0,1,1,1,1,2
MALLA,mortalidad institucional,otras muertes en personas mayores de 5 anos,2005-12-01,0,0,1,0,1,0,1
MINEROS,mortalidad institucional,otras muertes en personas mayores de 5 anos,2005-12-01,2,0,0,0,2,0,2
MOCOMOCO,mortalidad institucional,otras muertes en personas mayores de 5 anos,2005-12-01,0,0,1,0,1,0,1
MONTEAGUDO,mortalidad institucional,otras muertes en personas mayores de 5 anos,2005-12-01,3,0,1,0,4,0,4
MONTERO,mortalidad institucional,otras muertes en personas mayores de 5 anos,2005-12-01,3,1,14,3,17,4,21
ORURO,mortalidad institucional,otras muertes en personas mayores de 5 anos,2005-12-01,17,21,8,3,25,24,49
PADILLA,mortalidad institucional,otras muertes en personas mayores de 5 anos,2005-12-01,0,0,0,1,0,1,1
PATACAMAYA,mortalidad institucional,otras muertes en personas mayores de 5 anos,2005-12-01,0,0,1,1,1,1,2
PORONGO,mortalidad institucional,otras muertes en personas mayores de 5 anos,2005-12-01,0,0,1,0,1,0,1
PORTACHUELO,mortalidad institucional,otras muertes en personas mayores de 5 anos,2005-12-01,0,0,1,0,1,0,1
POTOSI,mortalidad institucional,otras muertes en personas mayores de 5 anos,2005-12-01,13,12,0,0,13,12,25
PRESTO,mortalidad institucional,otras muertes en personas mayores de 5 anos,2005-12-01,0,0,4,1,4,1,5
PUCARA,mortalidad institucional,otras muertes en personas mayores de 5 anos,2005-12-01,0,0,2,1,2,1,3
PUERTO ACOSTA,mortalidad institucional,otras muertes en personas mayores de 5 anos,2005-12-01,0,0,1,2,1,2,3
PUERTO VILLARROEL,mortalidad institucional,otras muertes en personas mayores de 5 anos,2005-12-01,2,0,2,0,4,0,4
PUNA,mortalidad institucional,otras muertes en personas mayores de 5 anos,2005-12-01,0,0,1,1,1,1,2
PUNATA,mortalidad institucional,otras muertes en personas mayores de 5 anos,2005-12-01,1,2,4,5,5,7,12
QUILLACOLLO,mortalidad institucional,otras muertes en personas mayores de 5 anos,2005-12-01,0,0,1,0,1,0,1
RIBERALTA,mortalidad institucional,otras muertes en personas mayores de 5 anos,2005-12-01,1,5,5,3,6,8,14
RURRENABAQUE,mortalidad institucional,otras muertes en personas mayores de 5 anos,2005-12-01,0,1,0,0,0,1,1
SACABA,mortalidad institucional,otras muertes en personas mayores de 5 anos,2005-12-01,1,0,2,5,3,5,8
SACACA,mortalidad institucional,otras muertes en personas mayores de 5 anos,2005-12-01,0,1,2,0,2,1,3
SAN ANDRES,mortalidad institucional,otras muertes en personas mayores de 5 anos,2005-12-01,0,0,2,0,2,0,2
SAN BORJA,mortalidad institucional,otras muertes en personas mayores de 5 anos,2005-12-01,1,0,0,0,1,0,1
SAN IGNACIO DE VELASCO,mortalidad institucional,otras muertes en personas mayores de 5 anos,2005-12-01,1,0,1,1,2,1,3
SAN JOAQUIN,mortalidad institucional,otras muertes en personas mayores de 5 anos,2005-12-01,0,0,0,1,0,1,1
SAN JUAN DE YAPACANI,mortalidad institucional,otras muertes en personas mayores de 5 anos,2005-12-01,0,1,1,0,1,1,2
SAN LUCAS,mortalidad institucional,otras muertes en personas mayores de 5 anos,2005-12-01,0,0,1,4,1,4,5
SAN MIGUEL DE VELASCO,mortalidad institucional,otras muertes en personas mayores de 5 anos,2005-12-01,0,0,2,0,2,0,2
SAN PEDRO DE BUENA VISTA,mortalidad institucional,otras muertes en personas mayores de 5 anos,2005-12-01,0,0,1,0,1,0,1
SAN PEDRO DE TIQUINA,mortalidad institucional,otras muertes en personas mayores de 5 anos,2005-12-01,0,0,0,2,0,2,2
SAN RAFAEL,mortalidad institucional,otras muertes en personas mayores de 5 anos,2005-12-01,0,0,1,0,1,0,1
SANTA CRUZ DE LA SIERRA,mortalidad institucional,otras muertes en personas mayores de 5 anos,2005-12-01,0,0,0,2,0,2,2
SANTIVAÃ‘ES,mortalidad institucional,otras muertes en personas mayores de 5 anos,2005-12-01,0,0,2,0,2,0,2
SENA,mortalidad institucional,otras muertes en personas mayores de 5 anos,2005-12-01,0,0,2,0,2,0,2
SIPE SIPE,mortalidad institucional,otras muertes en personas mayores de 5 anos,2005-12-01,0,0,1,1,1,1,2
SUCRE,mortalidad institucional,otras muertes en personas mayores de 5 anos,2005-12-01,10,12,0,0,10,12,22
TACOPAYA,mortalidad institucional,otras muertes en personas mayores de 5 anos,2005-12-01,0,0,0,1,0,1,1
TAPACARI,mortalidad institucional,otras muertes en personas mayores de 5 anos,2005-12-01,0,0,1,1,1,1,2
TARABUCO,mortalidad institucional,otras muertes en personas mayores de 5 anos,2005-12-01,0,0,6,2,6,2,8
TARIJA,mortalidad institucional,otras muertes en personas mayores de 5 anos,2005-12-01,17,14,1,0,18,14,32
TITO YUPANQUI (PARQUIPUJIO),mortalidad institucional,otras muertes en personas mayores de 5 anos,2005-12-01,0,0,0,1,0,1,1
TOMINA,mortalidad institucional,otras muertes en personas mayores de 5 anos,2005-12-01,0,1,0,2,0,3,3
TRINIDAD,mortalidad institucional,otras muertes en personas mayores de 5 anos,2005-12-01,2,9,1,4,3,13,16
TUPIZA,mortalidad institucional,otras muertes en personas mayores de 5 anos,2005-12-01,0,1,1,0,1,1,2
UNCIA,mortalidad institucional,otras muertes en personas mayores de 5 anos,2005-12-01,2,1,0,0,2,1,3
UYUNI,mortalidad institucional,otras muertes en personas mayores de 5 anos,2005-12-01,0,0,2,0,2,0,2
VILLA RIVERO,mortalidad institucional,otras muertes en personas mayores de 5 anos,2005-12-01,0,0,1,0,1,0,1
VILLA TUNARI,mortalidad institucional,otras muertes en personas mayores de 5 anos,2005-12-01,1,0,5,1,6,1,7
VILLA VACA GUZMAN (MUYUPAMPA),mortalidad institucional,otras muertes en personas mayores de 5 anos,2005-12-01,0,0,1,1,1,1,2
VILLAZON,mortalidad institucional,otras muertes en personas mayores de 5 anos,2005-12-01,0,0,0,2,0,2,2
VITICHI,mortalidad institucional,otras muertes en personas mayores de 5 anos,2005-12-01,0,0,0,1,0,1,1
WARNES,mortalidad institucional,otras muertes en personas mayores de 5 anos,2005-12-01,1,0,2,1,3,1,4
YACUIBA,mortalidad institucional,otras muertes en personas mayores de 5 anos,2005-12-01,2,1,0,0,2,1,3
YAMPARAEZ,mortalidad institucional,otras muertes en personas mayores de 5 anos,2005-12-01,0,0,2,0,2,0,2
YOTALA,mortalidad institucional,otras muertes en personas mayores de 5 anos,2005-12-01,0,0,2,1,2,1,3
YUNCHARA,mortalidad institucional,otras muertes en personas mayores de 5 anos,2005-12-01,0,0,0,1,0,1,1
